GEOID,insured12,uninsured12,total12,pct_ins12,insured17,uninsured17,total17,pct_ins17,pct_ins_chg,MHHI12,MHHI17
1400000US24001000100,3074,260,3334,0.9220155968806238,3147,341,3488,0.9022362385321101,-0.019779358348513743,45682,48125
1400000US24001000200,2500,278,2778,0.8999280057595392,2707,102,2809,0.963688145247419,0.06376013948787973,42712,49714
1400000US24001000300,2410,250,2660,0.9060150375939849,2287,168,2455,0.9315682281059063,0.025553190511921398,31806,45547
1400000US24001000400,2766,270,3036,0.9110671936758893,2634,148,2782,0.9468008626887131,0.03573366901282382,39583,44271
1400000US24001000500,2052,260,2312,0.8875432525951558,1935,270,2205,0.8775510204081632,-0.009992232186992522,28141,24470
1400000US24001000600,3028,271,3299,0.9178538951197333,2712,50,2762,0.9818971759594497,0.06404328083971644,45343,39865
1400000US24001000700,2877,559,3436,0.8373108265424912,3337,318,3655,0.9129958960328317,0.07568506949034048,27782,28853
1400000US24001000800,1841,197,2038,0.9033366045142296,2064,168,2232,0.9247311827956989,0.02139457828146929,30128,26990
1400000US24001001000,1673,563,2236,0.748211091234347,2156,245,2401,0.8979591836734694,0.14974809243912235,24558,24844
1400000US24001001100,1598,132,1730,0.923699421965318,1111,155,1266,0.8775671406003159,-0.046132281365002026,30273,35313
1400000US24001001200,2689,419,3108,0.8651866151866152,2878,143,3021,0.9526646805693479,0.08747806538273273,63885,66855
1400000US24001001300,1960,194,2154,0.9099350046425255,2040,65,2105,0.9691211401425178,0.0591861354999923,40772,48704
1400000US24001001401,3758,160,3918,0.9591628381827463,3515,287,3802,0.9245134139926354,-0.034649424190110856,60323,73115
1400000US24001001402,1344,126,1470,0.9142857142857143,1426,91,1517,0.9400131839156229,0.025727469629908684,47708,53393
1400000US24001001502,1816,142,1958,0.9274770173646578,1832,70,1902,0.9631966351209253,0.03571961775626753,53333,48409
1400000US24001001503,1785,174,1959,0.9111791730474732,1687,195,1882,0.8963868225292242,-0.014792350518249009,49081,47188
1400000US24001001600,1795,267,2062,0.8705140640155189,1538,79,1617,0.9511440940012369,0.080630029985718,44375,60455
1400000US24001001700,4073,291,4364,0.9333180568285976,4952,167,5119,0.9673764407110764,0.03405838388247884,37003,41237
1400000US24001001800,5124,542,5666,0.9043416872573244,4411,225,4636,0.9514667817083693,0.04712509445104485,27661,36290
1400000US24001001900,2215,304,2519,0.8793171893608575,2774,108,2882,0.9625260235947258,0.08320883423386838,49960,54338
1400000US24001002000,4824,438,5262,0.9167616875712656,5490,302,5792,0.9478591160220995,0.031097428450833853,52014,42427
1400000US24001002100,3331,398,3729,0.8932689729149906,2988,129,3117,0.958614051973051,0.06534507905806042,39677,46735
1400000US24001002200,3645,293,3938,0.925596749619096,3619,153,3772,0.9594379639448568,0.033841214325760816,39598,40915
1400000US24003701101,4124,140,4264,0.9671669793621013,3940,96,4036,0.9762140733399405,0.009047093977839205,111897,119801
1400000US24003701102,6717,809,7526,0.8925059792718576,7347,833,8180,0.8981662591687042,0.005660279896846587,91473,87878
1400000US24003701200,7674,613,8287,0.9260287196814287,8353,303,8656,0.9649953789279113,0.03896665924648257,91875,130036
1400000US24003701300,7366,322,7688,0.9581165452653486,7591,126,7717,0.983672411558896,0.025555866293547336,113542,119844
1400000US24003701400,3386,192,3578,0.946338736724427,3442,46,3488,0.9868119266055045,0.04047318988107751,125304,108438
1400000US24003702100,6080,65,6145,0.9894222945484134,6844,262,7106,0.9631297495074584,-0.026292545040954907,108214,123419
1400000US24003702204,4032,167,4199,0.9602286258633008,4061,105,4166,0.9747959673547768,0.014567341491475982,134891,138816
1400000US24003702205,4654,229,4883,0.953102600860127,5463,222,5685,0.9609498680738786,0.007847267213751619,96304,104795
1400000US24003702206,6229,679,6908,0.901708164447018,6279,209,6488,0.967786683107275,0.06607851866025705,94135,106642
1400000US24003702208,6620,657,7277,0.9097155421190051,6726,274,7000,0.9608571428571429,0.05114160073813778,100902,111057
1400000US24003702209,4163,188,4351,0.9567915421742128,4377,58,4435,0.9869222096956032,0.030130667521390375,138818,151944
1400000US24003702300,5453,225,5678,0.9603733709052483,5399,142,5541,0.9743728568850388,0.013999485979790505,125850,124158
1400000US24003702402,5549,361,5910,0.938917089678511,5989,193,6182,0.9687803299902944,0.029863240311783446,97481,107283
1400000US24003702500,5328,1362,6690,0.7964125560538117,5137,792,5929,0.8664192949907236,0.0700067389369119,70714,88482
1400000US24003702601,5184,202,5386,0.9624953583364277,5330,140,5470,0.9744058500914077,0.011910491754979935,97866,98953
1400000US24003702602,5569,353,5922,0.9403917595406958,5661,119,5780,0.9794117647058823,0.039020005165186555,126907,140712
1400000US24003702701,4407,104,4511,0.9769452449567724,3981,149,4130,0.9639225181598063,-0.013022726796966033,83698,91496
1400000US24003702702,3493,79,3572,0.9778835386338186,3695,20,3715,0.9946164199192463,0.016732881285427714,133846,161406
1400000US24003706101,3459,193,3652,0.9471522453450164,3350,273,3623,0.9246480817002484,-0.022504163644768038,61702,86944
1400000US24003706301,3504,620,4124,0.8496605237633366,3977,256,4233,0.9395227970706355,0.0898622733072989,67727,71693
1400000US24003706302,3266,166,3432,0.9516317016317016,2884,212,3096,0.9315245478036176,-0.020107153828084035,86964,91875
1400000US24003706401,4693,1738,6431,0.729746540195926,5905,1841,7746,0.7623289439710819,0.032582403775155866,62165,69945
1400000US24003706402,2641,207,2848,0.9273174157303371,2648,379,3027,0.874793524942187,-0.05252389078815012,54583,71979
1400000US24003706500,4525,749,5274,0.8579825559347743,4804,410,5214,0.9213655542769467,0.06338299834217231,67700,88854
1400000US24003706600,4602,440,5042,0.9127330424434749,5037,323,5360,0.9397388059701492,0.027005763526674387,86827,106064
1400000US24003706700,792,3,795,0.9962264150943396,821,23,844,0.9727488151658767,-0.023477599928462878,118500,96944
1400000US24003707001,6310,274,6584,0.9583839611178615,5918,296,6214,0.9523656260057933,-0.006018335112068174,93834,92298
1400000US24003707002,4229,235,4464,0.9473566308243727,4797,69,4866,0.9858199753390875,0.03846334451471478,96071,95852
1400000US24003708001,3518,230,3748,0.9386339381003201,3623,115,3738,0.969234884965222,0.03060094686490189,93438,106875
1400000US24003708004,4954,616,5570,0.889407540394973,5725,253,5978,0.9576781532285045,0.06827061283353142,64504,66769
1400000US24003730100,5965,767,6732,0.8860665478312537,10394,307,10701,0.971311092421269,0.08524454459001529,86125,102700
1400000US24003730203,4099,691,4790,0.855741127348643,4902,636,5538,0.8851570964247021,0.029415969076059034,34325,46779
1400000US24003730204,5560,679,6239,0.8911684564834108,5793,191,5984,0.9680815508021391,0.07691309431872828,71308,65163
1400000US24003730300,2721,382,3103,0.8768933290364164,3048,422,3470,0.878386167146974,0.0014928381105576705,61122,86568
1400000US24003730401,3683,485,4168,0.883637236084453,4979,283,5262,0.9462181679969593,0.06258093191250635,67964,74868
1400000US24003730402,4965,1083,6048,0.8209325396825397,5550,638,6188,0.8968972204266322,0.07596468074409257,53443,58911
1400000US24003730502,5376,528,5904,0.9105691056910569,5532,346,5878,0.9411364409663151,0.030567335275258234,87804,82404
1400000US24003730504,6828,540,7368,0.9267100977198697,6841,577,7418,0.9222162307899704,-0.004493866929899282,77992,89274
1400000US24003730505,3619,825,4444,0.8143564356435643,4256,401,4657,0.9138930642044234,0.0995366285608591,50483,50784
1400000US24003730506,3584,669,4253,0.842699271102751,3096,320,3416,0.9063231850117096,0.06362391390895861,38807,44831
1400000US24003730601,6778,213,6991,0.9695322557574024,6904,89,6993,0.9872729872729873,0.017740731515584862,142314,174271
1400000US24003730603,3592,141,3733,0.9622287704259309,2961,72,3033,0.9762611275964391,0.014032357170508214,113512,121016
1400000US24003730604,6310,55,6365,0.9913589945011784,7077,89,7166,0.9875802400223277,-0.0037787544788506766,130865,146295
1400000US24003730700,6433,328,6761,0.9514864664990386,7207,243,7450,0.9673825503355705,0.01589608383653196,114007,118433
1400000US24003730800,2262,194,2456,0.9210097719869706,2371,92,2463,0.9626471782379212,0.04163740625095058,143438,171106
1400000US24003730901,2326,129,2455,0.9474541751527495,2467,16,2483,0.9935561820378574,0.046102006885107905,112426,140048
1400000US24003730902,3474,163,3637,0.9551828430024746,4004,86,4090,0.9789731051344743,0.02379026213199975,133333,166591
1400000US24003731002,2979,225,3204,0.9297752808988764,3303,268,3571,0.9249509941192943,-0.004824286779582132,111307,105161
1400000US24003731003,3929,423,4352,0.9028033088235294,4085,62,4147,0.9850494333252954,0.08224612450176594,104896,91750
1400000US24003731004,3978,217,4195,0.9482717520858165,4204,145,4349,0.9666590020694412,0.01838724998362473,90679,104559
1400000US24003731102,6855,226,7081,0.9680836040107329,7334,272,7606,0.9642387588745727,-0.0038448451361602354,93182,121250
1400000US24003731103,4497,394,4891,0.9194438765078716,5023,233,5256,0.9556697108066972,0.03622583429882553,101679,114730
1400000US24003731104,4598,199,4797,0.9585157390035439,4024,275,4299,0.9360316352640149,-0.022484103739529027,112784,105982
1400000US24003731105,3104,216,3320,0.9349397590361446,3382,130,3512,0.9629840546697038,0.028044295633559257,94917,97250
1400000US24003731201,5949,300,6249,0.9519923187710033,6281,126,6407,0.9803340096769159,0.028341690905912542,115671,130370
1400000US24003731202,6543,215,6758,0.9681858538029002,7468,377,7845,0.9519439133205864,-0.016241940482313866,95029,101842
1400000US24003731203,6930,359,7289,0.9507477020167375,6920,159,7079,0.9775392004520412,0.026791498435303707,99275,125035
1400000US24003731204,5539,269,5808,0.9536845730027548,5863,372,6235,0.940336808340016,-0.013347764662738792,83274,82589
1400000US24003731303,6674,174,6848,0.9745911214953271,6539,253,6792,0.9627502944640753,-0.011840827031251777,107517,101771
1400000US24003731306,6343,414,6757,0.9387302057125944,5658,233,5891,0.9604481412323884,0.021717935519794063,104643,88000
1400000US24003731307,5646,527,6173,0.9146282196662887,6099,383,6482,0.9409132983647023,0.026285078698413566,82629,90028
1400000US24003731308,3164,204,3368,0.9394299287410927,3730,153,3883,0.9605974761782127,0.021167547437120016,73817,89375
1400000US24003731309,5067,459,5526,0.9169381107491856,5606,230,5836,0.9605894448252228,0.04365133407603716,85556,78245
1400000US24003731310,4794,438,5232,0.9162844036697247,5213,353,5566,0.9365792310456342,0.020294827375909485,98021,96792
1400000US24003731311,7292,1202,8494,0.8584883447139157,7663,304,7967,0.961842600728003,0.10335425601408732,95459,105769
1400000US24003740102,5876,488,6364,0.923318667504714,9630,542,10172,0.9467164766024381,0.023397809097724043,91950,105059
1400000US24003740103,7877,592,8469,0.9300980044869525,8201,315,8516,0.9630108031939878,0.03291279870703534,101795,113544
1400000US24003740104,6434,863,7297,0.8817322187200219,8093,321,8414,0.9618492987877347,0.08011708006771279,89782,97688
1400000US24003740105,3256,279,3535,0.921074964639321,3288,436,3724,0.882921589688507,-0.038153374950814056,58318,62685
1400000US24017851100,2616,153,2769,0.9447453954496208,2724,147,2871,0.9487983281086729,0.004052932659052155,101994,79167
1400000US24017851200,3838,400,4238,0.9056158565361019,4771,214,4985,0.9570712136409227,0.051455357104820854,67500,81563
1400000US24017851301,3978,363,4341,0.9163787145818936,4466,266,4732,0.9437869822485208,0.027408267666627184,124222,122314
1400000US24017851302,3465,353,3818,0.9075432163436354,4088,97,4185,0.9768219832735962,0.06927876692996071,106447,114241
1400000US24017851400,7975,720,8695,0.917193789534215,8350,396,8746,0.9547221587011205,0.037528369166905495,123955,124411
1400000US24017851500,7828,156,7984,0.9804609218436874,8494,375,8869,0.9577178937873492,-0.02274302805633821,84423,91489
1400000US24017990000,0,0,0,NaN,0,0,0,NaN,NaN,NA,NA
1400000US24019970100,2671,231,2902,0.9203997243280496,2459,270,2729,0.9010626603151337,-0.019337064012915905,50461,57266
1400000US24019970200,4510,434,4944,0.9122168284789643,5341,295,5636,0.9476579134137686,0.035441084934804246,52639,58651
1400000US24019970300,4425,545,4970,0.8903420523138833,3966,341,4307,0.9208265614116554,0.030484509097772117,66000,63631
1400000US24019970400,2790,272,3062,0.9111691704768126,3201,217,3418,0.9365125804564073,0.025343409979594722,42740,50145
1400000US24019970500,3144,661,3805,0.8262812089356111,3661,148,3809,0.9611446573903912,0.13486344845478015,22589,24449
1400000US24019970600,4173,606,4779,0.8731952291274325,4288,316,4604,0.9313640312771503,0.05816880214971776,42469,43468
1400000US24019970702,3650,365,4015,0.9090909090909091,3758,37,3795,0.9902503293807642,0.08115942028985512,58904,62255
1400000US24019970804,1579,219,1798,0.8781979977753059,2033,87,2120,0.9589622641509434,0.0807642663756375,61838,61971
1400000US24019970900,1547,236,1783,0.8676388109927089,1472,81,1553,0.9478428847392144,0.08020407374650551,44464,55492
1400000US24019990000,0,0,0,NaN,0,0,0,NaN,NaN,NA,NA
1400000US24021740200,4445,186,4631,0.9598358885769812,4416,235,4651,0.9494732315631047,-0.010362657013876508,78691,85313
1400000US24021750100,1099,268,1367,0.8039502560351134,1363,112,1475,0.9240677966101695,0.12011754057505608,51250,63155
1400000US24021750200,1280,170,1450,0.8827586206896552,1505,269,1774,0.8483652762119503,-0.03439334447770481,66063,78380
1400000US24021750300,1374,182,1556,0.8830334190231363,1415,221,1636,0.8649144254278729,-0.018118993595263366,41337,47120
1400000US24021750503,5089,1305,6394,0.7959024085079762,6608,914,7522,0.8784897633608083,0.08258735485283208,62741,52903
1400000US24021750504,4597,799,5396,0.8519273535952557,4653,583,5236,0.8886554621848739,0.03672810858961817,64247,55096
1400000US24021750505,4590,1483,6073,0.7558043800428125,6627,887,7514,0.8819536864519564,0.1261493064091439,53622,60172
1400000US24021750506,3468,474,3942,0.8797564687975646,4050,406,4456,0.9088868940754039,0.029130425277839267,105568,94250
1400000US24021750600,2577,126,2703,0.9533851276359601,2524,55,2579,0.9786739046141916,0.02528877697823151,79589,90078
1400000US24021750701,5064,262,5326,0.9508073601201652,5150,353,5503,0.9358531709976377,-0.01495418912252755,91958,92500
1400000US24021750702,2726,365,3091,0.8819152377871239,3376,508,3884,0.8692070030895983,-0.012708234697525578,51683,50767
1400000US24021750801,2649,222,2871,0.922675026123302,2769,157,2926,0.9463431305536568,0.02366810443035483,48911,49329
1400000US24021750802,3782,127,3909,0.9675108723458685,4723,108,4831,0.9776443800455392,0.010133507699670696,95625,98571
1400000US24021750803,5537,871,6408,0.8640761548064919,5695,417,6112,0.931773560209424,0.06769740540293212,86544,91596
1400000US24021751001,828,288,1116,0.7419354838709677,956,49,1005,0.9512437810945273,0.2093082972235596,114102,95568
1400000US24021751002,4456,255,4711,0.9458713648906814,5168,224,5392,0.9584569732937686,0.0125856084030872,76224,72231
1400000US24021751003,4600,581,5181,0.8878594865856012,5096,654,5750,0.8862608695652174,-0.0015986170203837746,59398,64048
1400000US24021751004,3841,297,4138,0.9282261962300629,3675,312,3987,0.92174567343867575,-0.006480522791387111,95708,97524
1400000US24021751201,4421,78,4499,0.9826628139586575,4533,79,4612,0.9828707718993929,2.0795794073535934e-4,102013,110521
1400000US24021751202,5700,170,5870,0.9710391822827938,6099,210,6309,0.9667142177841179,-0.004324964498675921,83860,95263
1400000US24021751203,1548,144,1692,0.9148936170212766,1828,77,1905,0.9595800524934384,0.04468643547216178,63295,89886
1400000US24021751301,2584,197,2781,0.9291621718806184,3388,120,3508,0.9657924743443558,0.03663030246373733,91304,94659
1400000US24021751302,2540,225,2765,0.918625678119349,3246,251,3497,0.9282241921647126,0.009598514045363604,77422,87026
1400000US24021751600,2750,203,2953,0.93125634947511,2808,160,2968,0.9460916442048517,0.014835294729741655,88241,90900
1400000US24021751701,2379,42,2421,0.9826517967781908,2308,75,2383,0.9685270667226186,-0.014124730055572243,104091,100333
1400000US24021751702,3643,115,3758,0.9693986162852581,3720,249,3969,0.9372637944066515,-0.03213482187860661,111125,87292
1400000US24021751801,3961,188,4149,0.9546878765967703,4701,87,4788,0.981829573934837,0.027141697338066706,110463,120903
1400000US24021751802,3656,300,3956,0.9241658240647118,3396,150,3546,0.9576988155668359,0.033532991502124077,108272,121033
1400000US24021751901,3994,222,4216,0.9473434535104365,4479,147,4626,0.9682230869001297,0.02087963338969323,109275,109750
1400000US24021751902,5618,158,5776,0.9726454293628809,5998,106,6104,0.9826343381389253,0.009988908776044414,97957,98354
1400000US24021751903,6077,352,6429,0.945248094571473,5752,157,5909,0.9734303604670841,0.028182265895611125,124286,130625
1400000US24021751904,2918,119,3037,0.9608165953243333,3283,61,3344,0.9817583732057417,0.020941777881408385,112250,113594
1400000US24021752001,4653,91,4744,0.9808178752107926,4961,111,5072,0.9781151419558359,-0.002702733254956624,101857,116080
1400000US24021752101,3360,83,3443,0.9758931164681963,3143,45,3188,0.9858845671267252,0.009991450658528911,140089,138526
1400000US24021752102,4232,353,4585,0.923009814612868,4074,159,4233,0.96243798724309,0.039428172630222025,106992,102061
1400000US24021752201,2230,155,2385,0.9350104821802935,2096,84,2180,0.9614678899082569,0.026457407727963456,90000,123750
1400000US24021752202,3510,109,3619,0.9698811826471401,4003,115,4118,0.9720738222438077,0.0021926395966676004,107721,144779
1400000US24021752204,5384,379,5763,0.9342356411591185,7401,233,7634,0.9694786481529998,0.035243006993881276,131641,142773
1400000US24021752301,4082,223,4305,0.9481997677119628,4341,247,4588,0.9461639058413251,-0.0020358618706376452,84756,89224
1400000US24021752302,3610,347,3957,0.9123073035127622,3873,193,4066,0.9525332021642893,0.04022589865152704,87885,115000
1400000US24021752303,2492,123,2615,0.9529636711281071,3401,137,3538,0.9612775579423403,0.008313886814233173,100114,113967
1400000US24021752501,4664,119,4783,0.9751202174367551,4873,97,4970,0.9804828973843058,0.005362679947550686,91724,105583
1400000US24021752502,2509,66,2575,0.9743689320388349,2439,125,2564,0.9512480499219969,-0.02312088211683805,102841,97070
1400000US24021752601,3687,133,3820,0.9651832460732984,4155,69,4224,0.9836647727272727,0.01848152665397429,114865,126307
1400000US24021752602,2622,116,2738,0.9576333089846604,2616,134,2750,0.9512727272727273,-0.0063605817119331,90972,102619
1400000US24021752603,3883,159,4042,0.9606630380999506,3713,79,3792,0.9791666666666666,0.018503628566716057,107476,120478
1400000US24021752801,2106,63,2169,0.970954356846473,1971,68,2039,0.9666503187837175,-0.0043040380627554775,80417,84076
1400000US24021752802,3259,280,3539,0.9208816049731563,3532,157,3689,0.957441040932502,0.03655943595934574,95857,90234
1400000US24021752900,2811,195,3006,0.935129740518962,2940,153,3093,0.950533462657614,0.015403722138651932,71932,65745
1400000US24021753001,4481,372,4853,0.9233463836801978,4441,411,4852,0.9152926628194559,-0.008053720860741964,78324,78021
1400000US24021753002,2538,195,2733,0.9286498353457738,2843,88,2931,0.9699761173660867,0.041326282020312854,66797,64420
1400000US24021765100,3407,520,3927,0.8675833969951617,3289,292,3581,0.9184585311365541,0.05087513414139233,50650,63237
1400000US24021766800,5037,282,5319,0.9469825155104343,5624,243,5867,0.9585818987557525,0.011599383245318173,54601,69787
1400000US24021767500,2591,330,2921,0.8870249914412872,2626,248,2874,0.9137091162143354,0.026684124773048157,71645,74225
1400000US24021767600,3258,318,3576,0.9110738255033557,2841,192,3033,0.9366963402571711,0.025622514753815384,83618,85380
1400000US24021770700,3074,318,3392,0.90625,3425,140,3565,0.9607293127629734,0.05447931276297335,85809,115977
1400000US24021772200,1796,241,2037,0.8816887579774177,1164,158,1322,0.8804841149773072,-0.0012046430001105835,51591,54844
1400000US24021773500,3984,576,4560,0.8736842105263158,4107,315,4422,0.9287652645861602,0.055081054059844314,85101,75167
1400000US24021775302,3808,462,4270,0.8918032786885246,4074,156,4230,0.9631205673758865,0.07131728868736187,94525,96750
1400000US24021775400,3239,390,3629,0.8925323780655828,3668,61,3729,0.9836417270045589,0.09110934893897604,57530,64516
1400000US24021775600,3466,175,3641,0.9519362812414172,3803,118,3921,0.969905636317266,0.017969355075848847,111250,125263
1400000US24023000100,3271,465,3736,0.8755353319057816,3595,315,3910,0.9194373401534527,0.0439020082476711,44364,48583
1400000US24023000200,3253,793,4046,0.8040039545229857,3655,365,4020,0.9092039800995025,0.10520002557651686,49974,49177
1400000US24023000300,2386,362,2748,0.8682678311499272,2465,87,2552,0.9659090909090909,0.09764125975916371,46941,54250
1400000US24023000400,2669,401,3070,0.8693811074918567,2714,268,2982,0.9101274312541918,0.04074632376233511,45893,47794
1400000US24023000500,3399,502,3901,0.8713150474237376,3728,290,4018,0.9278247884519661,0.05650974102822859,55741,52019
1400000US24023000600,5424,737,6161,0.8803765622463886,5449,489,5938,0.9176490400808353,0.03727247783444665,42069,47500
1400000US24023000700,4774,1091,5865,0.8139812446717818,5246,371,5617,0.9339505073882856,0.11996926271650377,36654,45250
1400000US24025301102,3344,299,3643,0.9179247872632446,3583,98,3681,0.9733767997826678,0.05545201251942322,104861,127303
1400000US24025301105,4103,147,4250,0.9654117647058823,3665,91,3756,0.9757720979765708,0.010360333270688526,88832,93114
1400000US24025301106,3931,239,4170,0.9426858513189449,4006,52,4058,0.9871858058156727,0.044499954496727834,100183,104392
1400000US24025301107,2868,143,3011,0.952507472600465,2994,202,3196,0.9367959949937422,-0.015711477606722757,66406,56865
1400000US24025301108,3250,130,3380,0.9615384615384616,3116,177,3293,0.9462496204069237,-0.015288841131537834,117096,135778
1400000US24025301201,1993,136,2129,0.9361202442461249,1883,102,1985,0.9486146095717884,0.012494365325663503,68464,70536
1400000US24025301202,6501,575,7076,0.9187394007914076,6772,358,7130,0.9497896213183731,0.03105022052696549,93077,84752
1400000US24025301204,4062,121,4183,0.9710733923021755,3934,66,4000,0.9835,0.012426607697824554,82048,90000
1400000US24025301205,3688,119,3807,0.9687417914368269,3884,334,4218,0.9208155523944997,-0.04792623904232718,80568,78819
1400000US24025301301,4663,380,5043,0.9246480269680746,4377,194,4571,0.9575585211113542,0.03291049414327962,68333,67313
1400000US24025301302,6371,780,7151,0.8909243462452804,6235,239,6474,0.9630831016373185,0.07215875539203809,49818,49300
1400000US24025301401,7203,357,7560,0.9527777777777777,7062,263,7325,0.9640955631399317,0.011317785362153998,69705,71962
1400000US24025301402,2039,165,2204,0.9251361161524501,2583,110,2693,0.9591533605644262,0.03401724441197618,80000,78935
1400000US24025301601,5674,576,6250,0.90784,6357,529,6886,0.9231774615161197,0.0153374615161197,45729,43758
1400000US24025301602,6733,1097,7830,0.8598978288633461,7601,599,8200,0.9269512195121952,0.06705339064884908,64797,75224
1400000US24025301702,7396,561,7957,0.9294960412215659,8326,493,8819,0.9440979702914163,0.014601929069850361,77168,82857
1400000US24025301703,4470,320,4790,0.9331941544885177,4678,175,4853,0.9639398310323511,0.030745676543833422,94338,105456
1400000US24025301704,3449,175,3624,0.951710816777042,3076,90,3166,0.9715729627289956,0.01986214595195368,74036,80647
1400000US24025302100,2155,129,2284,0.9435201401050788,2141,32,2173,0.9852738150023009,0.04175367489722215,81042,102279
1400000US24025302200,2174,266,2440,0.8909836065573771,3006,63,3069,0.9794721407624634,0.08848853420508629,73510,91750
1400000US24025302400,2220,298,2518,0.8816521048451151,3640,238,3878,0.9386281588447654,0.05697605399965022,62792,55962
1400000US24025302801,3654,217,3871,0.9439421338155516,3410,123,3533,0.9651853948485706,0.02124326103301899,71906,61081
1400000US24025302802,3956,742,4698,0.8420604512558536,4677,638,5315,0.8799623706491063,0.037901919393252714,52336,57463
1400000US24025302901,2179,533,2712,0.8034660766961652,2501,141,2642,0.9466313398940197,0.1431652631978545,28654,30114
1400000US24025302902,4174,468,4642,0.8991813873330461,3828,168,3996,0.9579579579579579,0.05877657062491182,54495,50652
1400000US24025303101,5874,398,6272,0.9365433673469388,5713,158,5871,0.9730880599557146,0.0365446926087758,96197,99461
1400000US24025303102,2991,57,3048,0.9812992125984252,2745,48,2793,0.9828141783029001,0.0015149657044748466,119706,124063
1400000US24025303201,5452,259,5711,0.9546489231308002,5567,124,5691,0.9782112106835354,0.02356228755273526,100857,113549
1400000US24025303203,3167,103,3270,0.9685015290519877,3374,76,3450,0.9779710144927536,0.009469485440765868,86250,77500
1400000US24025303204,4623,235,4858,0.9516261836146562,4393,62,4455,0.9860830527497194,0.034456869135063184,74674,85811
1400000US24025303205,1624,62,1686,0.963226571767497,1569,63,1632,0.9613970588235294,-0.0018295129439676039,115458,135850
1400000US24025303206,3070,94,3164,0.9702907711757269,3406,58,3464,0.983256351039261,0.012965579863534082,91750,108295
1400000US24025303300,5573,205,5778,0.9645205953617169,6015,199,6214,0.9679755391052463,0.003454943743529393,98241,93654
1400000US24025303400,4218,144,4362,0.9669876203576341,4439,95,4534,0.9790471989413322,0.012059578583698105,103056,112321
1400000US24025303501,5840,157,5997,0.9738202434550609,6225,197,6422,0.9693241980691374,-0.0044960453859235194,85807,86975
1400000US24025303502,3342,209,3551,0.9411433399042524,3442,98,3540,0.9723163841807909,0.031173044276538553,97846,87652
1400000US24025303602,3186,145,3331,0.9564695286700691,3658,263,3921,0.9329252741647539,-0.023544254505315165,96830,118304
1400000US24025303603,6547,367,6914,0.9469192941857102,6995,32,7027,0.9954461363312935,0.04852684214558334,120440,106526
1400000US24025303605,5154,403,5557,0.9274788554975706,5884,296,6180,0.9521035598705502,0.02462470437297959,74356,66932
1400000US24025303606,3373,94,3467,0.9728872223824633,3140,65,3205,0.9797191887675507,0.006831966385087429,129297,144261
1400000US24025303700,3557,156,3713,0.9579854565041745,3645,181,3826,0.9526921066387872,-0.00529334986538732,70718,97941
1400000US24025303801,2270,200,2470,0.9190283400809717,2486,51,2537,0.9798975167520694,0.0608691766710977,66289,76071
1400000US24025303802,1282,120,1402,0.9144079885877318,1553,122,1675,0.9271641791044776,0.012756190516745813,50268,82250
1400000US24025303803,4735,60,4795,0.9874869655891554,4817,113,4930,0.977079107505071,-0.010407858084084398,69451,74923
1400000US24025303900,2140,168,2308,0.9272097053726169,2290,30,2320,0.9870689655172413,0.05985926014462439,67993,77841
1400000US24025304101,4471,71,4542,0.984368119771026,4104,148,4252,0.9651928504233303,-0.019175269347695756,91295,93246
1400000US24025304102,3494,184,3678,0.9499728113104948,3842,127,3969,0.9680020156210632,0.018029204310568425,102380,96116
1400000US24025304201,5956,363,6319,0.9425542016141795,6300,198,6498,0.9695290858725761,0.02697488425839667,107094,122760
1400000US24025304202,6693,458,7151,0.9359530135645364,6715,220,6935,0.9682768565248738,0.03232384296033741,92035,106236
1400000US24025305100,6667,368,7035,0.9476901208244491,7293,252,7545,0.9666003976143142,0.01891027678986501,77288,91447
1400000US24025305200,2378,393,2771,0.8581739444243955,2481,132,2613,0.9494833524684271,0.09130940804403154,66500,74583
1400000US24025305300,1994,161,2155,0.9252900232018562,1970,211,2181,0.9032553874369555,-0.022034635764900612,67438,71406
1400000US24025306100,3434,493,3927,0.8744588744588745,3705,176,3881,0.9546508631795929,0.08019198872071842,41461,58125
1400000US24025306200,1864,323,2187,0.8523090992226795,2019,157,2176,0.9278492647058824,0.07554016548320286,49000,48494
1400000US24025306300,2091,104,2195,0.952619589977221,2526,49,2575,0.9809708737864078,0.028351283809186834,96667,103641
1400000US24025306400,6022,340,6362,0.9465576862621817,5951,111,6062,0.9816892114813592,0.035131525219177506,94649,96840
1400000US24025306500,1598,7,1605,0.9956386292834891,1999,12,2011,0.9940328194927897,-0.001605809790699464,67708,73393
1400000US24027601103,5110,505,5615,0.9100623330365093,6013,413,6426,0.9357298474945533,0.02566751445804405,122958,124447
1400000US24027601104,6070,193,6263,0.9691840970780776,6499,58,6557,0.9911544913832545,0.021970394305176888,166065,185417
1400000US24027601105,3559,209,3768,0.9445329087048833,4610,91,4701,0.9806424165071261,0.03610950780224287,93633,124212
1400000US24027601107,3791,846,4637,0.8175544533103299,4607,599,5206,0.8849404533230888,0.06738600001275885,64844,88462
1400000US24027601108,3572,73,3645,0.9799725651577503,3707,73,3780,0.9806878306878307,7.15265530080389e-4,108271,113281
1400000US24027601201,7153,408,7561,0.9460388837455364,8030,158,8188,0.9807034684904739,0.0346645847449375,81263,101136
1400000US24027601203,2252,243,2495,0.9026052104208416,4903,173,5076,0.9659180457052797,0.0633128352844381,119583,104975
1400000US24027601204,4553,262,4815,0.9455867082035306,5038,709,5747,0.8766312858882895,-0.0689554223152411,75791,92480
1400000US24027602100,7800,344,8144,0.9577603143418467,7404,258,7662,0.966327329678935,0.008567015337088257,154969,176848
1400000US24027602201,3149,110,3259,0.9662473151273396,3292,173,3465,0.9500721500721501,-0.016175165055189566,144338,155114
1400000US24027602202,5038,236,5274,0.9552521805081532,5157,274,5431,0.9495488860246731,-0.005703294483480059,101311,125029
1400000US24027602302,5967,356,6323,0.9436976118930888,7346,462,7808,0.9408299180327869,-0.0028676938603018343,113021,118667
1400000US24027602303,3777,115,3892,0.9704522096608428,3843,38,3881,0.9902087090955939,0.019756499434751107,156513,178665
1400000US24027602304,4906,105,5011,0.9790460985831172,4830,234,5064,0.9537914691943128,-0.025254629388804406,145469,152656
1400000US24027602305,3719,78,3797,0.9794574664208586,3765,92,3857,0.9761472647135079,-0.003310201707350746,155625,145547
1400000US24027602306,5005,163,5168,0.9684597523219814,5376,153,5529,0.972327726532827,0.003867974210845504,92750,109647
1400000US24027602600,5695,1117,6812,0.8360246623605402,7211,693,7904,0.9123228744939271,0.07629821213338694,65927,69263
1400000US24027602700,4936,125,5061,0.9753013238490417,5275,137,5412,0.9746858832224686,-6.154406265730383e-4,143929,147781
1400000US24027602800,5312,624,5936,0.894878706199461,5976,82,6058,0.9864641795972268,0.0915854733977658,104295,120764
1400000US24027602900,3415,844,4259,0.8018314158253111,4743,348,5091,0.9316440777843252,0.1298126619590141,76182,79904
1400000US24027603001,5021,315,5336,0.9409670164917541,5843,237,6080,0.9610197368421053,0.020052720350351216,120156,128611
1400000US24027603003,4117,50,4167,0.9880009599232061,3840,72,3912,0.9815950920245399,-0.006405867898666262,161000,169167
1400000US24027603004,5957,565,6522,0.9133701318613923,6625,58,6683,0.9913212629058806,0.07795113104448836,161500,195573
1400000US24027604001,5824,243,6067,0.9599472556452943,5805,100,5905,0.983065198983912,0.02311794333861772,119079,125515
1400000US24027604002,7475,225,7700,0.9707792207792207,7965,141,8106,0.9826054774241303,0.01182625664490955,155833,175500
1400000US24027605102,8038,144,8182,0.98240039110242,10646,246,10892,0.9774146162320969,-0.004985774870323034,181434,168836
1400000US24027605103,4812,171,4983,0.9656833232992174,4957,137,5094,0.9731056144483706,0.007422291149153271,177125,179722
1400000US24027605104,4525,54,4579,0.9882070321030793,5329,125,5454,0.9770810414374771,-0.011125990665602159,210889,205259
1400000US24027605401,4710,282,4992,0.9435096153846154,4823,129,4952,0.9739499192245558,0.03044030383994034,93424,81611
1400000US24027605402,6410,458,6868,0.9333139196272568,6460,533,6993,0.9237809237809238,-0.009532995846333048,77590,84763
1400000US24027605502,5327,95,5422,0.9824787901143489,5045,137,5182,0.9735623311462756,-0.00891645896807336,115477,129787
1400000US24027605503,5360,608,5968,0.8981233243967829,5818,632,6450,0.902015503875969,0.0038921794791860753,81310,89423
1400000US24027605504,2690,122,2812,0.9566145092460882,2532,88,2620,0.966412213740458,0.009797704494369897,202571,201250
1400000US24027605505,5851,196,6047,0.9675872333388457,6057,213,6270,0.9660287081339712,-0.001558525204874428,178077,180825
1400000US24027605601,5525,663,6188,0.8928571428571429,6465,139,6604,0.9789521502119928,0.08609500735484987,71516,103357
1400000US24027605602,6384,228,6612,0.9655172413793104,7648,543,8191,0.9337077279941399,-0.03180951338517046,111136,135926
1400000US24027606601,2923,149,3072,0.9514973958333334,2975,22,2997,0.9926593259926594,0.04116193015932601,118364,122143
1400000US24027606603,7039,1164,8203,0.8581006948677313,7071,348,7419,0.9530934088152042,0.09499271394747288,79133,81075
1400000US24027606604,3513,490,4003,0.877591806145391,4533,132,4665,0.9717041800643087,0.09411237391891769,91324,99241
1400000US24027606606,4053,322,4375,0.9264,4765,289,5054,0.942817570241393,0.01641757024139301,78542,87026
1400000US24027606607,4370,314,4684,0.9329632792485055,4590,439,5029,0.9127063034400478,-0.020256975808457756,118382,112609
1400000US24027606701,2644,84,2728,0.969208211143695,2596,239,2835,0.9156966490299824,-0.05351156211371266,119861,137721
1400000US24027606704,6809,1139,7948,0.8566935078007046,6470,289,6759,0.9572421955910637,0.10054868779035908,92194,102760
1400000US24027606705,1960,205,2165,0.9053117782909931,1893,59,1952,0.9697745901639344,0.06446281187294134,95694,112188
1400000US24027606706,4670,207,4877,0.9575558745130203,4777,90,4867,0.9815081158824738,0.02395224136945351,128343,127769
1400000US24027606707,3469,384,3853,0.9003373994290164,3611,131,3742,0.9649919828968466,0.06465458346783026,96439,92097
1400000US24027606803,5387,268,5655,0.9526083112290009,5631,289,5920,0.9511824324324324,-0.001425878796568525,95089,91136
1400000US24027606804,3145,122,3267,0.9626568717477808,3472,26,3498,0.9925671812464265,0.029910309498645704,114271,118315
1400000US24027606805,3933,209,4142,0.9495412844036697,4095,185,4280,0.9567757009345794,0.007234416530909726,175962,148207
1400000US24027606806,6035,264,6299,0.9580885854897603,7255,357,7612,0.9531003678402522,-0.0049882176495080754,126930,137228
1400000US24027606901,4420,745,5165,0.8557599225556631,5512,469,5981,0.9215850192275539,0.06582509667189074,78548,86823
1400000US24027606904,3773,420,4193,0.8998330550918197,4377,390,4767,0.9181875393329137,0.018354484241094093,85451,98542
1400000US24027606905,6100,350,6450,0.9457364341085271,6389,441,6830,0.9354319180087848,-0.010304516099742367,102821,104731
1400000US24027606906,4900,750,5650,0.8672566371681416,5621,798,6419,0.8756815703380589,0.008424933169917326,87214,89795
1400000US24027606907,3844,939,4783,0.8036796989337236,5406,1018,6424,0.8415317559153176,0.037852056981593996,72585,73213
1400000US24029950100,3388,697,4085,0.82937576499388,3386,391,3777,0.8964786867884564,0.06710292179457644,60774,61494
1400000US24029950200,4521,417,4938,0.9155528554070473,4390,320,4710,0.9320594479830149,0.016506592575967538,63491,65725
1400000US24029950300,4916,388,5304,0.9268476621417798,5013,251,5264,0.9523176291793313,0.025469967037551444,31926,51557
1400000US24029950400,2765,119,2884,0.9587378640776699,3011,72,3083,0.976646123905287,0.017908259827617123,69142,67292
1400000US24029950500,2257,332,2589,0.8717651602935497,2294,188,2482,0.9242546333601934,0.052489473066643755,46781,47917
1400000US24029990000,0,0,0,NaN,0,0,0,NaN,NaN,NA,NA
1400000US24031700101,4080,333,4413,0.9245411284840245,4204,174,4378,0.9602558245774326,0.03571469609340816,162813,162171
1400000US24031700103,5657,143,5800,0.9753448275862069,5104,163,5267,0.9690525916081261,-0.006292235978080818,153313,151435
1400000US24031700104,4395,575,4970,0.8843058350100603,5254,380,5634,0.9325523606673767,0.04824652565731635,116667,114762
1400000US24031700105,5908,695,6603,0.8947448129638044,5932,334,6266,0.946696457069901,0.05195164410609665,98871,111719
1400000US24031700204,2008,138,2146,0.9356943150046598,1832,89,1921,0.9536699635606455,0.017975648555985657,81827,94583
1400000US24031700205,6385,177,6562,0.9730265163060042,10070,341,10411,0.9672461819229661,-0.005780334383038155,143790,137121
1400000US24031700206,5537,270,5807,0.9535043912519373,5382,165,5547,0.9702541914548405,0.016749800202903176,121995,133953
1400000US24031700207,5419,455,5874,0.9225400068096697,5464,224,5688,0.960618846694796,0.03807883988512628,81978,101946
1400000US24031700208,1741,104,1845,0.9436314363143632,2311,57,2368,0.9759290540540541,0.032297617739690865,103942,136625
1400000US24031700304,6732,997,7729,0.8710053046965972,8176,323,8499,0.9619955288857512,0.09099022418915403,111789,123906
1400000US24031700306,5876,926,6802,0.8638635695383711,6914,419,7333,0.9428610391381427,0.07899746959977161,110737,112547
1400000US24031700308,5365,296,5661,0.9477124183006536,5614,409,6023,0.9320936410426698,-0.015618777257983774,100148,87867
1400000US24031700309,4557,880,5437,0.8381460364171418,5569,213,5782,0.963161535800761,0.12501549938361922,82446,74898
1400000US24031700310,4915,682,5597,0.8781490083973558,6039,443,6482,0.931656896019747,0.053507887622391226,75566,75393
1400000US24031700311,6368,447,6815,0.9344093910491563,9503,479,9982,0.9520136245241435,0.017604233474987185,131583,131438
1400000US24031700312,4635,475,5110,0.9070450097847358,5505,332,5837,0.9431214665067672,0.036076456722031414,132473,130329
1400000US24031700400,2043,130,2173,0.9401748734468477,1955,108,2063,0.9476490547746,0.0074741813277523494,123098,110179
1400000US24031700500,5657,466,6123,0.9238935162502041,6547,209,6756,0.9690645352279456,0.04517101897774145,101724,138427
1400000US24031700604,6443,254,6697,0.9620725698073764,6411,53,6464,0.9918007425742574,0.029728172766881,172627,189620
1400000US24031700606,4314,195,4509,0.9567531603459747,4097,115,4212,0.9726970560303894,0.015943895684414677,158523,155250
1400000US24031700607,7653,251,7904,0.9682439271255061,7583,238,7821,0.9695691088096151,0.0013251816841090003,154461,176184
1400000US24031700608,5664,189,5853,0.9677088672475653,5833,207,6040,0.965728476821192,-0.001980390426373324,219737,242438
1400000US24031700610,1843,144,1987,0.9275289380976346,2108,121,2229,0.9457155675190668,0.018186629421432232,139199,155938
1400000US24031700611,5930,697,6627,0.8948242040138826,6168,188,6356,0.9704216488357458,0.07559744482186315,141515,173393
1400000US24031700613,5789,351,6140,0.9428338762214984,6078,264,6342,0.9583727530747398,0.015538876853241401,118779,131159
1400000US24031700614,3998,537,4535,0.8815876515986769,4917,386,5303,0.9272110126343579,0.04562336103568099,75134,66344
1400000US24031700615,2906,68,2974,0.9771351714862139,2958,29,2987,0.9902912621359223,0.013156090649708463,146898,171667
1400000US24031700616,4246,239,4485,0.946711259754738,4673,80,4753,0.9831685251420156,0.03645726538727756,145179,164265
1400000US24031700704,2232,740,2972,0.7510094212651414,2695,582,3277,0.8223985352456515,0.07138911398051018,61250,88750
1400000US24031700706,2969,651,3620,0.8201657458563536,4165,293,4458,0.9342754598474652,0.11410971399111158,66026,85091
1400000US24031700710,5306,1229,6535,0.8119357306809487,5397,1075,6472,0.8338998763906057,0.02196414570965699,94191,90495
1400000US24031700711,5070,524,5594,0.9063282087951376,5679,359,6038,0.9405432262338522,0.03421501743871458,96209,103567
1400000US24031700713,3787,1777,5564,0.6806254493170381,4530,1343,5873,0.7713264089902946,0.09070095967325653,49293,55670
1400000US24031700715,4990,1063,6053,0.8243846026763588,5919,493,6412,0.9231129132875858,0.098728310611227,100088,102772
1400000US24031700716,6756,679,7435,0.908675184936113,8142,736,8878,0.917098445595855,0.008423260659741971,81828,94952
1400000US24031700717,4452,1141,5593,0.7959949937421777,5908,1566,7474,0.7904736419587904,-0.005521351783387307,66346,64911
1400000US24031700718,3972,267,4239,0.9370134465675867,5122,194,5316,0.9635063957863055,0.02649294921871881,113816,109792
1400000US24031700719,5748,2559,8307,0.6919465511014807,7653,2046,9699,0.7890504175688215,0.09710386646734082,66250,65045
1400000US24031700720,2926,481,3407,0.8588200763134722,3228,518,3746,0.8617191671115857,0.0028990907981134573,100019,98092
1400000US24031700721,1978,471,2449,0.8076766026949775,2464,811,3275,0.7523664122137405,-0.05531019048123709,62594,46310
1400000US24031700722,3491,757,4248,0.821798493408663,4186,539,4725,0.8859259259259259,0.06412743251726294,79309,74602
1400000US24031700723,2822,230,3052,0.9246395806028833,3113,282,3395,0.9169366715758468,-0.00770290902703652,53829,55450
1400000US24031700724,2362,956,3318,0.7118746232670283,2386,1249,3635,0.6563961485557084,-0.05547847471131995,35699,48901
1400000US24031700810,4448,809,5257,0.8461099486399087,5063,323,5386,0.9400297066468623,0.09391975800695351,98510,96140
1400000US24031700811,4127,693,4820,0.8562240663900414,3910,424,4334,0.9021688970927549,0.04594483070271349,82650,82167
1400000US24031700812,3750,423,4173,0.8986340762041697,3540,573,4113,0.8606856309263311,-0.03794844527783858,80850,91671
1400000US24031700813,4852,1136,5988,0.8102872411489646,5448,461,5909,0.9219834151294636,0.11169617398049903,80000,74091
1400000US24031700815,6643,1803,8446,0.7865261662325361,6629,824,7453,0.8894404937609016,0.10291432752836549,81080,99005
1400000US24031700816,6656,1107,7763,0.8574004895014814,7968,985,8953,0.8899810119513012,0.03258052244981979,73225,83940
1400000US24031700817,4411,369,4780,0.9228033472803348,5686,506,6192,0.9182816537467701,-0.004521693533564686,84018,89970
1400000US24031700818,5149,1056,6205,0.8298146655922644,5611,1126,6737,0.8328632922665875,0.0030486266743231516,68767,65457
1400000US24031700819,5839,1274,7113,0.8208913257415998,6547,541,7088,0.9236738148984198,0.10278248915681998,87159,88125
1400000US24031700820,2370,621,2991,0.7923771313941825,2275,490,2765,0.8227848101265823,0.0304076787323998,69709,73733
1400000US24031700822,1243,426,1669,0.7447573397243858,1488,358,1846,0.8060671722643553,0.06130983253996947,62813,71818
1400000US24031700823,3094,306,3400,0.91,3307,126,3433,0.9632974075152927,0.05329740751529266,107083,120909
1400000US24031700824,2861,162,3023,0.9464108501488587,2731,135,2866,0.9528960223307746,0.00648517218191591,141351,134917
1400000US24031700826,5664,288,5952,0.9516129032258065,5525,30,5555,0.9945994599459946,0.04298655672018814,130410,120550
1400000US24031700828,2374,82,2456,0.9666123778501629,2209,12,2221,0.994597028365601,0.027984650515438192,153833,137396
1400000US24031700829,2816,125,2941,0.9574974498469908,3118,92,3210,0.9713395638629283,0.01384211401593749,121857,125469
1400000US24031700830,1994,546,2540,0.7850393700787401,2769,409,3178,0.8713027061044682,0.08626333602572811,65697,68929
1400000US24031700832,2448,262,2710,0.9033210332103321,2847,475,3322,0.8570138470800722,-0.04630718613025986,62071,71976
1400000US24031700833,3821,770,4591,0.8322805489000218,3403,599,4002,0.8503248375812094,0.01804428868118757,72880,88137
1400000US24031700834,4365,693,5058,0.8629893238434164,4713,564,5277,0.893121091529278,0.030131767685861566,83387,79559
1400000US24031700835,4240,342,4582,0.9253601047577477,4639,181,4820,0.962448132780083,0.03708802802233535,141266,131528
1400000US24031700901,3341,259,3600,0.9280555555555555,4077,404,4481,0.9098415532247266,-0.018214002330828927,76250,81591
1400000US24031700902,2593,955,3548,0.7308342728297632,3588,499,4087,0.877905554196232,0.14707128136646874,81964,74708
1400000US24003740201,5997,760,6757,0.8875240491342312,6993,465,7458,0.9376508447304908,0.050126795596259544,60155,80227
1400000US24003740203,4888,404,5292,0.9236583522297808,6057,271,6328,0.9571744627054362,0.03351611047565539,133659,128184
1400000US24003740303,3711,430,4141,0.8961603477420913,4085,418,4503,0.9071729957805907,0.01101264803849944,82942,98958
1400000US24003740304,3497,135,3632,0.962830396475771,4871,173,5044,0.9657018239492466,0.002871427473475685,88343,95258
1400000US24003740305,9837,541,10378,0.9478704952784737,10568,731,11299,0.9353040092043544,-0.012566486074119254,92091,92478
1400000US24003740400,0,0,0,NaN,0,0,0,NaN,NaN,NA,NA
1400000US24003740500,7978,731,8709,0.9160638420025261,9806,841,10647,0.9210106133183056,0.004946771315779475,108828,110486
1400000US24003740601,4197,26,4223,0.9938432394032678,3154,77,3231,0.9761683689260291,-0.017674870477238702,60980,76343
1400000US24003740602,3084,77,3161,0.975640620056944,2679,123,2802,0.9561027837259101,-0.019537836331033898,55833,64981
1400000US24003740603,581,32,613,0.9477977161500816,1180,33,1213,0.9727947238252267,0.024997007675145122,85227,67863
1400000US24003740701,4916,305,5221,0.9415820723999234,5365,249,5614,0.9556465977912362,0.014064525391312754,89397,92879
1400000US24003740702,8793,476,9269,0.9486460243823498,9317,113,9430,0.988016967126193,0.03937094274384323,107198,108031
1400000US24003740800,3860,163,4023,0.9594829729057917,4364,163,4527,0.963993814888447,0.004510841982655389,104688,104020
1400000US24003740900,6774,465,7239,0.935764608371322,7093,633,7726,0.9180688584002071,-0.017695749971114894,89333,90377
1400000US24003741000,2172,84,2256,0.9627659574468085,2319,89,2408,0.9630398671096345,2.739096628260329e-4,115927,142361
1400000US24003750101,4232,445,4677,0.9048535385931152,3930,338,4268,0.9208059981255857,0.015952459532470487,52019,55492
1400000US24003750102,2138,252,2390,0.8945606694560669,2652,233,2885,0.9192374350086655,0.024676765552598567,55130,54097
1400000US24003750201,2221,549,2770,0.8018050541516245,2591,445,3036,0.8534255599472991,0.051620505795674565,61528,46806
1400000US24003750202,2906,336,3242,0.8963602714373843,3221,173,3394,0.9490276959340012,0.05266742449661688,63859,75135
1400000US24003750203,1238,265,1503,0.8236859614105123,1036,40,1076,0.9628252788104089,0.1391393173998966,58403,67692
1400000US24003750300,2644,160,2804,0.9429386590584878,2761,192,2953,0.9349813748730105,-0.007957284185477365,66097,80000
1400000US24003750400,3928,227,4155,0.945367027677497,3791,148,3939,0.9624270119319625,0.01705998425446542,90089,93558
1400000US24003750801,5391,341,5732,0.9405094207955338,5952,397,6349,0.9374704677902032,-0.0030389530053306357,77341,94904
1400000US24003750803,5962,1341,7303,0.8163768314391346,6794,742,7536,0.9015392781316348,0.08516244669250017,58948,57886
1400000US24003750804,3456,894,4350,0.7944827586206896,3382,194,3576,0.9457494407158836,0.151266682095194,73942,63922
1400000US24003750900,2556,314,2870,0.8905923344947735,2698,243,2941,0.9173750425025502,0.026782708007776712,59815,62768
1400000US24003751000,3380,391,3771,0.896313975072925,3707,467,4174,0.8881169142309535,-0.00819706084197147,59435,68059
1400000US24003751102,3437,253,3690,0.9314363143631437,3659,199,3858,0.9484188698807673,0.01698255551762362,64201,59896
1400000US24003751103,4879,666,5545,0.8798917944093778,4667,416,5083,0.9181585677749361,0.03826677336555828,74500,60477
1400000US24003751200,3788,359,4147,0.9134313961900169,3992,239,4231,0.943512172063342,0.03008077587332514,66964,97284
1400000US24003751400,3731,304,4035,0.9246592317224287,3537,327,3864,0.9153726708074534,-0.009286560914975261,106458,103682
1400000US24003751500,5533,617,6150,0.8996747967479675,6391,533,6924,0.9230213749277874,0.023346578179819888,66806,71451
1400000US24003751600,4698,158,4856,0.9674629324546952,4894,153,5047,0.969684961363186,0.0022220289084908806,73371,81295
1400000US24003751700,2511,155,2666,0.9418604651162791,2740,21,2761,0.9923940601231438,0.05053359500686472,157946,172604
1400000US24003980000,0,0,0,NaN,0,0,0,NaN,NaN,NA,NA
1400000US24003990000,0,0,0,NaN,0,0,0,NaN,NaN,NA,NA
1400000US24005400100,4329,88,4417,0.9800769753226172,4377,109,4486,0.975702184574231,-0.004374790748386204,52188,49833
1400000US24005400200,2287,249,2536,0.901813880126183,2029,249,2278,0.8906935908691835,-0.011120289256999483,67153,76389
1400000US24005400400,4908,404,5312,0.9239457831325302,5282,285,5567,0.9488054607508533,0.024859677618323084,97904,114386
1400000US24005400500,2373,39,2412,0.9838308457711443,2516,9,2525,0.9964356435643564,0.012604797793212108,120333,157708
1400000US24005400600,2731,146,2877,0.9492526937782412,2756,153,2909,0.9474046063939499,-0.0018480873842913192,63787,85583
1400000US24005400701,2468,360,2828,0.8727015558698727,2667,238,2905,0.9180722891566265,0.045370733286753784,58328,69661
1400000US24005400702,1564,50,1614,0.9690210656753407,1767,168,1935,0.9131782945736434,-0.05584277110169733,81250,90938
1400000US24005400800,2567,224,2791,0.9197420279469725,2314,218,2532,0.9139020537124802,-0.005839974234492229,62860,88864
1400000US24005400900,1827,316,2143,0.8525431637890807,1846,198,2044,0.9031311154598826,0.05058795167080188,50110,65481
1400000US24005401000,2263,157,2420,0.9351239669421487,2125,33,2158,0.9847080630213161,0.04958409607916736,62230,98636
1400000US24005401101,5983,755,6738,0.887948946274859,5275,639,5914,0.8919513019952655,0.004002355720406525,57791,65522
1400000US24005401102,985,167,1152,0.8550347222222222,966,39,1005,0.9611940298507463,0.1061593076285241,43362,53469
1400000US24005401200,3032,559,3591,0.8443330548593706,2711,167,2878,0.9419735927727588,0.09764053791338823,64271,70156
1400000US24005401301,3378,204,3582,0.9430485762144054,3386,240,3626,0.9338113623827909,-0.009237213831614466,60000,62963
1400000US24005401302,2201,233,2434,0.9042728019720625,2525,203,2728,0.9255865102639296,0.021313708291867073,43986,46731
1400000US24005401400,1753,24,1777,0.9864940911648846,1591,127,1718,0.9260768335273574,-0.060417257637527255,104276,114875
1400000US24005401503,6401,142,6543,0.9782974170869632,6373,96,6469,0.9851599938166641,0.00686257672970092,84669,96039
1400000US24005401504,5402,728,6130,0.8812398042414356,5840,599,6439,0.9069731324739867,0.025733328232551145,80927,88697
1400000US24005401505,3637,304,3941,0.9228622177112408,4239,105,4344,0.975828729281768,0.05296651157052723,71982,73375
1400000US24005401506,4885,398,5283,0.9246640166572023,4791,416,5207,0.9201075475321683,-0.004556469125034046,70227,75604
1400000US24005401507,4625,771,5396,0.8571163825055597,5213,907,6120,0.851797385620915,-0.005318996884644656,55666,54545
1400000US24005402201,2976,562,3538,0.8411531938948559,3327,254,3581,0.9290700921530298,0.08791689825817395,102685,84135
1400000US24005402202,1488,69,1557,0.9556840077071291,1398,122,1520,0.9197368421052632,-0.03594716560186595,112813,128281
1400000US24005402302,4435,512,4947,0.896502931069335,5126,399,5525,0.9277828054298642,0.03127987436052926,70588,85714
1400000US24005402303,5813,907,6720,0.8650297619047619,6070,562,6632,0.9152593486127865,0.050229586708024576,64433,69772
1400000US24005402304,3058,634,3692,0.8282773564463706,3509,139,3648,0.9618969298245614,0.13361957337819086,57317,70202
1400000US24005402305,1956,258,2214,0.8834688346883469,1841,290,2131,0.8639136555607696,-0.019555179127577316,43342,57888
1400000US24005402306,3327,512,3839,0.8666319353998437,3488,465,3953,0.8823678219074121,0.01573588650756841,54063,48431
1400000US24005402307,4853,956,5809,0.8354277844723704,6035,182,6217,0.9707254302718353,0.1352976457994649,52808,63743
1400000US24005402403,2277,266,2543,0.895399134880063,1895,80,1975,0.959493670886076,0.064094536006013,47266,65461
1400000US24005402404,4533,761,5294,0.8562523611635814,4949,345,5294,0.9348318851530034,0.07857952398942203,37813,51552
1400000US24005402405,2692,290,2982,0.9027498323272971,3225,292,3517,0.9169746943417686,0.014224862014471484,50583,60335
1400000US24005402406,5692,895,6587,0.8641263093972977,5540,552,6092,0.9093893630991464,0.04526305370184869,54344,65434
1400000US24005402407,1295,336,1631,0.7939914163090128,1401,68,1469,0.953710006807352,0.15971859049833914,70676,51964
1400000US24005402503,3910,453,4363,0.8961723584689434,4671,278,4949,0.943827035764801,0.047654677295857595,40750,47679
1400000US24005402504,4412,153,4565,0.9664841182913472,4051,98,4149,0.9763798505664015,0.009895732275054359,93205,97351
1400000US24005402505,2712,211,2923,0.9278138898392063,3700,164,3864,0.9575569358178054,0.029743045978599114,48588,62574
1400000US24005402506,3748,418,4166,0.899663946231397,4303,218,4521,0.9517805795178058,0.05211663328640881,70341,83107
1400000US24005402509,8050,720,8770,0.9179019384264538,9177,425,9602,0.9557383878358675,0.037836449409413664,85380,87650
1400000US24005402602,1800,231,2031,0.8862629246676514,1996,173,2169,0.9202397418165053,0.03397681714885381,74000,72750
1400000US24005402603,6194,406,6600,0.9384848484848485,6115,334,6449,0.9482090246549852,0.009724176170136767,86756,107398
1400000US24005402604,5403,327,5730,0.9429319371727749,5905,252,6157,0.959070976124736,0.016139038951961115,80342,82167
1400000US24005403100,2128,250,2378,0.894869638351556,2117,165,2282,0.9276950043821209,0.03282536603056496,59148,69301
1400000US24005403201,2408,302,2710,0.888560885608856,3125,242,3367,0.9281259281259281,0.03956504251707205,65152,72426
1400000US24005403202,1878,229,2107,0.8913146654010441,1951,216,2167,0.9003230272265805,0.009008361825536437,66971,67697
1400000US24005403300,2058,143,2201,0.935029532030895,2321,183,2504,0.9269169329073482,-0.008112599123546782,70029,74013
1400000US24005403401,2993,210,3203,0.9344364658133,3310,59,3369,0.9824873849807064,0.04805091916740645,53173,65403
1400000US24005403402,3479,973,4452,0.7814465408805031,5160,295,5455,0.9459211732355637,0.16447463235506055,36490,48445
1400000US24005403500,4859,182,5041,0.9638960523705614,4964,151,5115,0.9704789833822092,0.006582931011647752,78345,97375
1400000US24005403601,4482,327,4809,0.9320024953212727,4565,219,4784,0.9542224080267558,0.02221991270548318,83089,83622
1400000US24005403602,5047,407,5454,0.9253758709204254,5870,94,5964,0.9842387659289068,0.05886289500848141,81183,89477
1400000US24005403701,6258,273,6531,0.9581993569131833,6922,466,7388,0.9369247428262046,-0.021274614086978616,83434,77417
1400000US24005403702,4164,257,4421,0.9418683555756616,4439,660,5099,0.8705628554618553,-0.07130550011380632,78561,77446
1400000US24005403801,1684,40,1724,0.9767981438515081,1619,40,1659,0.9758890898131405,-9.090540383676071e-4,156709,198158
1400000US24005403802,2801,52,2853,0.9817735716789344,2721,104,2825,0.9631858407079646,-0.018587730970969774,182188,158908
1400000US24005403803,3216,69,3285,0.9789954337899544,3249,20,3269,0.9938819210767819,0.01488648728682751,117682,103846
1400000US24005404101,4514,187,4701,0.9602212295256328,5548,172,5720,0.9699300699300699,0.009708840404437091,95308,90271
1400000US24005404102,5319,509,5828,0.9126630061770762,5161,685,5846,0.882825863838522,-0.029837142338554168,66542,65676
1400000US24005404201,5126,1168,6294,0.8144264378773435,5691,533,6224,0.9143637532133676,0.09993731533602412,65439,76985
1400000US24005404202,6732,1196,7928,0.8491422805247225,7634,1606,9240,0.8261904761904761,-0.022951804334246373,54197,54093
1400000US24005404402,6156,229,6385,0.9641346906812842,6015,318,6333,0.949786830885836,-0.01434785979544817,114875,114583
1400000US24005404403,4376,653,5029,0.870153111950686,4289,628,4917,0.8722798454342079,0.002126733483521881,55479,48194
1400000US24005404404,4012,840,4852,0.8268755152514426,4424,240,4664,0.9485420240137221,0.12166650876227947,62679,81613
1400000US24005404501,6206,1045,7251,0.8558819473176114,6347,658,7005,0.9060670949321913,0.05018514761457993,62391,72741
1400000US24005404502,3472,296,3768,0.921443736730361,3202,757,3959,0.8087900985097247,-0.11265363822063623,53523,51452
1400000US24005404600,2153,233,2386,0.902347024308466,2681,171,2852,0.9400420757363254,0.03769505142785934,74948,101197
1400000US24005404800,1856,100,1956,0.9488752556237219,1861,44,1905,0.9769028871391076,0.028027631515385676,108750,120938
1400000US24005404900,4859,82,4941,0.983404169196519,4125,115,4240,0.972877358490566,-0.01052681070595296,113241,134777
1400000US24005405000,4082,288,4370,0.934096109839817,4610,94,4704,0.9800170068027211,0.045920896962904134,84031,101964
1400000US24005406000,5414,135,5549,0.9756712921247072,5631,381,6012,0.9366267465069861,-0.03904454561772108,111989,105972
1400000US24005407001,3191,97,3288,0.9704987834549879,2931,77,3008,0.9744015957446809,0.003902812289693025,92344,97153
1400000US24005407002,5770,277,6047,0.9541921614023483,5717,129,5846,0.977933629832364,0.023741468430015678,91636,102009
1400000US24005408100,6017,151,6168,0.9755188067444877,5177,320,5497,0.9417864289612516,-0.03373237778323601,97772,108448
1400000US24005408200,1908,98,2006,0.9511465603190429,1844,45,1889,0.9761778718898888,0.025031311570845927,138958,150750
1400000US24005408302,2927,30,2957,0.9898545823469733,2980,6,2986,0.9979906229068989,0.008136040559925561,106822,126667
1400000US24005408303,3675,0,3675,1,3239,122,3361,0.9637012793811366,-0.03629872061886341,149087,167069
1400000US24005408304,4562,98,4660,0.9789699570815451,5089,101,5190,0.9805394990366089,0.001569541955063758,81134,89417
1400000US24005408400,603,34,637,0.9466248037676609,678,19,697,0.9727403156384505,0.026115511870789643,79643,63971
1400000US24005408502,5062,301,5363,0.9438746969979489,4404,195,4599,0.9575994781474233,0.013724781149474397,90403,91335
1400000US24005408503,2808,467,3275,0.8574045801526717,3149,397,3546,0.8880428652002256,0.030638285047553837,54729,59853
1400000US24005408505,3754,112,3866,0.9710294878427315,3780,106,3886,0.9727225939269172,0.0016931060841857137,89938,84269
1400000US24005408506,3714,725,4439,0.836674926785312,3839,692,4531,0.8472743323769587,0.010599405591646738,48933,46997
1400000US24005408507,4675,809,5484,0.8524799416484318,5682,1070,6752,0.8415284360189573,-0.010951505629474445,51767,58682
1400000US24005408601,3492,307,3799,0.9191892603316663,3938,77,4015,0.9808219178082191,0.06163265747655289,80926,102902
1400000US24005408602,2023,75,2098,0.9642516682554814,2041,69,2110,0.9672985781990522,0.003046909943570819,88533,98462
1400000US24005408702,2405,12,2417,0.9950351675630947,2430,67,2497,0.9731678013616339,-0.02186736620146079,107050,98333
1400000US24005408703,5677,180,5857,0.9692675431108075,6234,161,6395,0.9748240813135262,0.005556538202718619,78482,94922
1400000US24005408704,5632,63,5695,0.9889376646180861,5473,219,5692,0.9615249472944484,-0.027412717323637703,132743,111607
1400000US24005408800,2216,69,2285,0.9698030634573304,2555,77,2632,0.9707446808510638,9.416173937334404e-4,70431,89556
1400000US24005408900,2566,78,2644,0.970499243570348,2585,44,2629,0.9832635983263598,0.012764354756011786,85221,102772
1400000US24005410100,5616,223,5839,0.9618085288576811,5484,57,5541,0.989713048186248,0.027904519328566857,149459,116735
1400000US24005410200,4553,198,4751,0.9583245632498422,4791,52,4843,0.9892628536031386,0.030938290353296427,117986,144514
1400000US24005411101,2075,208,2283,0.9088918090232151,2125,88,2213,0.9602349751468595,0.051343166123644424,91083,97813
1400000US24005411102,2699,154,2853,0.9460217315106905,2987,79,3066,0.9742335290280496,0.02821179751735914,88523,103311
1400000US24005411201,3169,105,3274,0.9679291386682957,3129,25,3154,0.9920735573874445,0.024144418719148852,97250,118676
1400000US24005411202,3527,117,3644,0.9678924259055982,3721,51,3772,0.9864793213149523,0.0185868954093541,90313,123229
1400000US24005411302,3025,366,3391,0.8920672368033029,3538,146,3684,0.9603691639522258,0.06830192714892291,105833,98750
1400000US24005411303,5610,303,5913,0.9487569761542364,5969,323,6292,0.9486649713922441,-9.200476199222596e-5,73793,70173
1400000US24005411306,4656,462,5118,0.9097303634232122,5099,285,5384,0.9470653789004457,0.0373350154772335,77792,86179
1400000US24005411307,3415,248,3663,0.9322959322959323,3631,224,3855,0.94189364461738,0.009597712321447682,71403,78565
1400000US24005411308,3213,92,3305,0.9721633888048411,3227,88,3315,0.9734539969834087,0.0012906081785676315,82171,89917
1400000US24005411309,8253,379,8632,0.9560936051899908,8542,50,8592,0.9941806331471136,0.03808702795712282,97961,107718
1400000US24005411404,3698,259,3957,0.9345463735152894,3497,157,3654,0.9570333880678709,0.022487014552581508,90417,87250
1400000US24005411406,4167,170,4337,0.9608023979709477,4211,120,4331,0.9722927730316324,0.011490375060684732,90076,85065
1400000US24005411407,8332,720,9052,0.9204595669465312,10544,344,10888,0.9684055841293167,0.04794601718278546,50019,57608
1400000US24005411408,3083,238,3321,0.9283348389039446,3254,320,3574,0.910464465584779,-0.017870373319165633,53213,65135
1400000US24005411409,4971,215,5186,0.9585422290782877,5086,156,5242,0.9702403662724151,0.011698137194127378,92163,101821
1400000US24005411410,4275,355,4630,0.9233261339092873,4506,277,4783,0.9420865565544637,0.01876042264517641,74583,91750
1400000US24005420100,3114,428,3542,0.8791643139469226,3390,299,3689,0.9189482244510707,0.03978391050414809,48456,53781
1400000US24005420200,2264,142,2406,0.940980881130507,2514,90,2604,0.9654377880184332,0.024456906887926122,42526,57143
1400000US24005420301,2546,197,2743,0.9281808239154211,2238,277,2515,0.8898608349900596,-0.03831998892536148,46786,52314
1400000US24005420302,2539,253,2792,0.9093839541547278,2259,315,2574,0.8776223776223776,-0.03176157653235023,59737,57389
1400000US24005420303,1236,99,1335,0.9258426966292135,1267,85,1352,0.9371301775147929,0.011287480885579404,67163,61250
1400000US24005420401,5818,723,6541,0.8894664424399938,5747,483,6230,0.9224719101123595,0.033005467672365674,58359,54581
1400000US24005420402,1977,137,2114,0.9351939451277199,1825,147,1972,0.9254563894523327,-0.009737555675387255,54668,58679
1400000US24005420500,2750,503,3253,0.8453735013833384,2953,397,3350,0.8814925373134328,0.036119035930094356,54235,51616
1400000US24005420600,3272,659,3931,0.8323581785805139,3494,706,4200,0.8319047619047619,-4.5341667575193867e-4,46801,52883
1400000US24005420701,2554,620,3174,0.8046628859483301,2676,533,3209,0.8339046431910252,0.029241757242695066,39214,47934
1400000US24005420702,1780,207,1987,0.8958228485153498,1932,82,2014,0.9592850049652433,0.0634621564498935,56532,36574
1400000US24005420800,3017,339,3356,0.8989868891537545,2955,265,3220,0.9177018633540373,0.018714974200282786,54625,63017
1400000US24005420900,2749,560,3309,0.8307645814445451,3393,177,3570,0.9504201680672268,0.11965558662268172,45199,37688
1400000US24005421000,1640,247,1887,0.8691043985161632,1562,102,1664,0.9387019230769231,0.06959752456075996,24280,26402
1400000US24005421101,2428,432,2860,0.848951048951049,2801,232,3033,0.9235080778107484,0.07455702885969939,41691,45373
1400000US24005421102,1887,377,2264,0.8334805653710248,2290,102,2392,0.9573578595317725,0.12387729416074778,48750,53772
1400000US24005421200,1620,153,1773,0.9137055837563451,1524,111,1635,0.9321100917431193,0.018404507986774177,44851,51563
1400000US24005421300,2671,201,2872,0.9300139275766016,2650,299,2949,0.8986096982027806,-0.031404229373821035,32697,40391
1400000US24005430101,3173,1257,4430,0.7162528216704289,3685,1041,4726,0.7797291578501905,0.06347633617976156,42979,45952
1400000US24005430104,2481,190,2671,0.9288655934107076,2679,160,2839,0.9436421275096865,0.014776534098978833,55929,79833
1400000US24005430200,2550,360,2910,0.8762886597938144,2456,190,2646,0.9281934996220711,0.051904839828256666,49201,40887
1400000US24005430300,5209,1200,6409,0.812763301607115,5227,441,5668,0.9221947776993649,0.1094314760922499,44583,35022
1400000US24005430400,3796,506,4302,0.8823802882380288,4217,147,4364,0.9663153070577452,0.08393501881971632,65203,76757
1400000US24005430600,2259,137,2396,0.9428213689482471,2218,102,2320,0.9560344827586207,0.0132131138103736,71833,95385
1400000US24005430700,4460,293,4753,0.938354723332632,4830,453,5283,0.9142532651902329,-0.024101458142399168,76693,90226
1400000US24005430800,3320,287,3607,0.9204324923759357,3263,221,3484,0.9365671641791045,0.016134671803168743,64583,73981
1400000US24005430900,3808,884,4692,0.8115942028985508,5241,397,5638,0.929584959205392,0.1179907563068412,49297,50913
1400000US24005440100,4339,344,4683,0.9265428144351912,4440,236,4676,0.9495295124037639,0.022986697968572778,76046,68977
1400000US24005440200,2180,334,2514,0.8671439936356404,2330,78,2408,0.967607973421927,0.10046397978628652,57991,64041
1400000US24005440300,1725,374,2099,0.8218199142448785,1914,106,2020,0.9475247524752475,0.12570483823036893,56597,60040
1400000US24005440400,5391,375,5766,0.9349635796045785,4736,225,4961,0.9546462406772828,0.01968266107270422,63640,74410
1400000US24005440500,2685,344,3029,0.8864311654011224,2987,240,3227,0.9256275178184072,0.03919635241728481,60980,71957
1400000US24005440600,2091,117,2208,0.9470108695652174,2231,69,2300,0.97,0.022989130434782568,108438,108929
1400000US24005440701,5573,993,6566,0.84876637222053,5431,1418,6849,0.7929624762739086,-0.055803895946621385,49018,59610
1400000US24005440702,4845,310,5155,0.9398642095053347,4247,579,4826,0.8800248653128885,-0.05983934419244619,75339,62250
1400000US24005440800,2709,419,3128,0.8660485933503836,3036,137,3173,0.9568231957138355,0.0907746023634518,57712,66875
1400000US24005440900,3177,424,3601,0.8822549291863371,3405,340,3745,0.9092122830440588,0.02695735385772169,42098,72428
1400000US24005441000,3148,303,3451,0.9121993625036221,3672,75,3747,0.9799839871897518,0.06778462468612967,52802,62895
1400000US24005441101,1867,214,2081,0.897164824603556,2021,92,2113,0.9564600094652154,0.05929518486165941,61429,63684
1400000US24005441102,4011,568,4579,0.875955448787945,4532,453,4985,0.9091273821464393,0.03317193335849433,70134,57125
1400000US24005450100,3575,234,3809,0.9385665529010239,3617,203,3820,0.9468586387434555,0.008292085842431685,50575,54313
1400000US24005450200,3121,293,3414,0.9141769185705917,2939,228,3167,0.9280075781496685,0.01383065957907681,48804,62389
1400000US24005450300,2921,342,3263,0.8951884768617836,2947,209,3156,0.9337769328263625,0.03858845596457894,58169,48623
1400000US24005450400,1936,206,2142,0.903828197945845,2095,134,2229,0.939883355764917,0.03605515781907198,63000,70714
1400000US24005450501,3326,808,4134,0.8045476536042574,3957,352,4309,0.9183105128800185,0.11376285927576113,39375,48929
1400000US24005450503,4694,1010,5704,0.8229312762973352,5382,1031,6413,0.8392328083580227,0.016301532060687518,45966,54291
1400000US24005450504,4755,1023,5778,0.8229491173416407,4609,770,5379,0.8568507157464212,0.033901598404780575,42839,38271
1400000US24005450800,3095,612,3707,0.8349069328297815,3384,373,3757,0.9007186585041256,0.06581172567434412,41964,42179
1400000US24005450900,3624,272,3896,0.9301848049281314,3777,374,4151,0.9099012286196098,-0.020283576308521623,77394,76607
1400000US24005451000,1517,304,1821,0.8330587589236683,1634,56,1690,0.9668639053254438,0.13380514640177543,75417,79519
1400000US24005451100,2062,334,2396,0.8606010016694491,2163,98,2261,0.9566563467492261,0.09605534507977698,82386,90417
1400000US24005451200,3438,555,3993,0.8610067618332081,3491,79,3570,0.9778711484593837,0.1168643866261756,66583,74539
1400000US24005451300,2417,665,3082,0.7842310188189487,3345,537,3882,0.8616692426584235,0.07743822383947474,47806,48563
1400000US24005451401,3017,381,3398,0.8878752207180695,3641,362,4003,0.9095678241319011,0.021692603413831613,69091,73889
1400000US24005451402,4484,1522,6006,0.7465867465867466,4082,1186,5268,0.7748671222475323,0.028280375660785673,47173,57585
1400000US24005451500,3603,445,4048,0.8900691699604744,3540,210,3750,0.944,0.05393083003952559,59408,62244
1400000US24005451600,1896,158,2054,0.9230769230769231,1924,109,2033,0.9463846532218396,0.023307730144916494,59038,55324
1400000US24005451701,2312,319,2631,0.878753325731661,3600,157,3757,0.9582113388341762,0.07945801310251521,62100,85000
1400000US24005451702,1930,119,2049,0.9419228892142508,1734,99,1833,0.9459901800327333,0.00406729081848245,72875,83250
1400000US24005451801,4724,327,5051,0.9352603444862404,5212,530,5742,0.907697666318356,-0.02756267816788438,69332,65290
1400000US24005451802,3274,178,3452,0.9484356894553881,3601,290,3891,0.9254690310974043,-0.022966658357983838,55304,68405
1400000US24005451803,4132,493,4625,0.8934054054054054,3882,217,4099,0.9470602585996585,0.053654853194253116,63993,74574
1400000US24005451900,2209,247,2456,0.8994299674267101,2447,152,2599,0.9415159676798769,0.04208600025316678,56786,78500
1400000US24005452000,2138,226,2364,0.9043993231810491,2538,100,2638,0.9620924943138741,0.057693171132825016,52734,70625
1400000US24005452100,3123,326,3449,0.9054798492316614,3186,194,3380,0.942603550295858,0.0371237010641966,54272,76384
1400000US24005452300,2471,600,3071,0.8046239010094431,2401,705,3106,0.7730199613650998,-0.03160393964434338,51172,49167
1400000US24005452400,3052,315,3367,0.9064449064449065,3204,201,3405,0.9409691629955947,0.03452425655068825,63145,67875
1400000US24005452500,3476,343,3819,0.9101859125425504,3408,276,3684,0.9250814332247557,0.014895520682205232,54750,52371
1400000US24005490100,4004,69,4073,0.9830591701448563,3799,88,3887,0.9773604322099305,-0.005698737934925813,118493,142950
1400000US24005490200,2656,93,2749,0.9661695161877046,2822,86,2908,0.9704264099037139,0.004256893716009236,83750,111292
1400000US24005490301,4306,582,4888,0.8809328968903437,5379,441,5820,0.9242268041237114,0.04329390723336768,44950,56609
1400000US24005490302,3409,259,3668,0.9293893129770993,4592,256,4848,0.9471947194719472,0.017805406494847964,59844,81307
1400000US24005490400,1613,12,1625,0.9926153846153846,1726,22,1748,0.9874141876430206,-0.005201196972363986,157500,148182
1400000US24005490500,3733,59,3792,0.9844409282700421,3632,40,3672,0.9891067538126361,0.004665825542593982,106075,156607
1400000US24005490601,2058,15,2073,0.9927641099855282,2135,47,2182,0.9784601283226397,-0.014303981662888487,104750,103667
1400000US24005490602,2879,242,3121,0.9224607497596924,2708,123,2831,0.9565524549629106,0.03409170520321825,63832,83233
1400000US24005490603,2232,91,2323,0.9608265174343521,2086,37,2123,0.9825718323127649,0.021745314878412803,102188,106087
1400000US24005490605,4544,195,4739,0.9588520784975734,4481,261,4742,0.9449599325179249,-0.013892145979648496,9150,11190
1400000US24005490701,1470,8,1478,0.9945872801082544,1355,8,1363,0.9941305942773294,-4.566858309249522e-4,94091,102500
1400000US24005490703,2500,139,2639,0.9473285335354301,3226,131,3357,0.9609770628537384,0.013648529318308289,81576,92386
1400000US24005490800,3244,117,3361,0.9651889318655162,3430,85,3515,0.9758179231863442,0.010628991320827952,67750,87727
1400000US24005490900,3870,661,4531,0.8541160891635401,4183,36,4219,0.9914671723157146,0.13735108315217448,50925,50217
1400000US24005491000,2165,0,2165,1,2152,37,2189,0.983097304705345,-0.016902695294655046,128636,144000
1400000US24005491100,3350,250,3600,0.9305555555555556,3886,218,4104,0.9468810916179338,0.016325536062378188,91071,88793
1400000US24005491201,1717,184,1901,0.9032088374539716,1482,78,1560,0.95,0.04679116254602833,67784,74250
1400000US24005491202,1673,78,1751,0.9554540262707024,1724,155,1879,0.9175093134646088,-0.03794471280609357,73867,72083
1400000US24005491300,2973,253,3226,0.921574705517669,3233,405,3638,0.8886750962067069,-0.03289960931096203,58953,55440
1400000US24005491401,4504,715,5219,0.8630005748227629,5172,528,5700,0.9073684210526316,0.04436784622986867,42315,43456
1400000US24005491402,2515,658,3173,0.792625275764261,2665,151,2816,0.9463778409090909,0.15375256514482993,48707,40347
1400000US24005491500,3013,687,3700,0.8143243243243243,3531,369,3900,0.9053846153846153,0.09106029106029101,48578,64538
1400000US24005491600,2112,454,2566,0.8230709275136399,2933,209,3142,0.9334818586887333,0.11041093117509349,53705,60017
1400000US24005491701,3559,385,3944,0.9023833671399595,3713,342,4055,0.9156596794081381,0.013276312268178603,84954,73828
1400000US24005491900,1603,233,1836,0.8730936819172114,1708,159,1867,0.9148366363149437,0.041742954397732346,58467,62025
1400000US24005492001,1284,166,1450,0.8855172413793103,1215,228,1443,0.841995841995842,-0.04352139938346833,55577,55375
1400000US24005492002,3239,377,3616,0.8957411504424779,3717,246,3963,0.9379258137774413,0.0421846633349634,66991,74819
1400000US24005492101,2903,336,3239,0.8962642790984872,3448,253,3701,0.9316400972710078,0.03537581817252067,46972,61971
1400000US24005492102,2119,138,2257,0.9388568896765618,1888,190,2078,0.9085659287776708,-0.03029096089889094,66898,70441
1400000US24005492200,4343,272,4615,0.9410617551462622,4849,176,5025,0.9649751243781095,0.02391336923184728,65399,58103
1400000US24005492300,3627,549,4176,0.8685344827586207,3827,386,4213,0.9083788274388797,0.03984434468025899,64485,70066
1400000US24005492401,3647,347,3994,0.913119679519279,3515,199,3714,0.9464189553042541,0.03329927578497516,95988,88237
1400000US24005492402,5615,306,5921,0.9483195406181388,6117,540,6657,0.9188823794502028,-0.029437161167936043,77925,76063
1400000US24005492500,3078,406,3484,0.883467278989667,2615,238,2853,0.9165790396074308,0.033111760617763775,26413,NA
1400000US24005492600,2929,347,3276,0.8940781440781441,3517,98,3615,0.9728907330567081,0.07881258897856402,68810,66494
1400000US24005980000,0,0,0,NaN,0,0,0,NaN,NaN,NA,NA
1400000US24005980100,0,0,0,NaN,0,0,0,NaN,NaN,NA,NA
1400000US24005980200,0,0,0,NaN,0,0,0,NaN,NaN,NA,NA
1400000US24009860101,3047,184,3231,0.9430516867842773,2826,301,3127,0.9037416053725615,-0.03931008141171577,105230,124706
1400000US24009860102,2702,60,2762,0.9782766111513396,2612,80,2692,0.9702823179791976,-0.007994293172141953,110833,84609
1400000US24009860200,5888,373,6261,0.9404248522600224,5812,145,5957,0.9756588887023669,0.035234036442344574,106458,126859
1400000US24009860300,4003,100,4103,0.9756275895686083,4780,28,4808,0.9941763727121464,0.01854878314353814,111438,128155
1400000US24009860401,8783,620,9403,0.9340635967244496,9634,405,10039,0.9596573363880865,0.025593739663636872,85139,96875
1400000US24009860402,3019,143,3162,0.954775458570525,3440,264,3704,0.9287257019438445,-0.02604975662668052,83966,92105
1400000US24009860501,5379,347,5726,0.9393992315752707,6037,325,6362,0.9489154353976736,0.009516203822402924,129625,135369
1400000US24009860502,2891,225,3116,0.9277920410783055,2959,170,3129,0.9456695429849792,0.0178775019066737,96761,100625
1400000US24009860600,7225,182,7407,0.9754286485756717,6808,448,7256,0.938257993384785,-0.03717065519088669,126607,132682
1400000US24009860701,1993,279,2272,0.8772007042253521,2703,210,2913,0.9279093717816684,0.05070866755631631,79615,88929
1400000US24009860702,2790,248,3038,0.9183673469387755,2948,221,3169,0.9302619122751656,0.011894565336390106,62763,73550
1400000US24009860703,3193,356,3549,0.8996900535362073,3595,195,3790,0.9485488126649076,0.0488587591287003,75246,95313
1400000US24009860801,6120,294,6414,0.9541627689429373,6797,300,7097,0.9577286177257996,0.0035658487828623686,110670,119831
1400000US24009860802,4529,389,4918,0.9209028060187068,4689,236,4925,0.9520812182741116,0.031178412255404853,91625,86324
1400000US24009860900,5718,642,6360,0.8990566037735849,6478,494,6972,0.9291451520367183,0.030088548263133452,72538,93454
1400000US24009861001,1188,59,1247,0.9526864474739375,1061,21,1082,0.9805914972273567,0.02790504975341923,106513,130000
1400000US24009861003,5696,683,6379,0.89292992632074,5430,346,5776,0.9400969529085873,0.04716702658784733,86295,81068
1400000US24009861004,7246,711,7957,0.9106447153449793,6315,523,6838,0.9235156478502486,0.012870932505269383,80971,85612
1400000US24009990100,0,0,0,NaN,0,0,0,NaN,NaN,NA,NA
1400000US24011955000,2381,836,3217,0.7401305564190239,2790,662,3452,0.8082271147161066,0.06809655829708272,52411,45346
1400000US24011955100,5467,519,5986,0.9132976946207818,5080,342,5422,0.9369236444116562,0.0236259497908744,60606,58281
1400000US24011955201,3422,348,3770,0.9076923076923077,3406,282,3688,0.9235357917570499,0.01584348406474223,64234,51250
1400000US24011955202,2239,204,2443,0.9164961113385182,1944,93,2037,0.9543446244477173,0.03784851310919912,69853,55795
1400000US24011955301,3000,375,3375,0.8888888888888888,3876,242,4118,0.9412336085478388,0.052344719658949934,73098,70250
1400000US24011955302,2470,356,2826,0.8740268931351733,2709,266,2975,0.9105882352941177,0.036561342158944354,63352,44589
1400000US24011955400,1854,372,2226,0.8328840970350404,1801,205,2006,0.8978065802592223,0.06492248322418193,69375,56786
1400000US24011955500,3637,449,4086,0.8901125795398923,4107,272,4379,0.9378853619547842,0.04777278241489191,59947,62891
1400000US24011955600,3853,674,4527,0.8511155290479346,3995,333,4328,0.9230591497227357,0.07194362067480109,39176,36349
1400000US24013501001,4304,276,4580,0.9397379912663756,4088,224,4312,0.948051948051948,0.008313956785572452,75671,72222
1400000US24013501002,4730,285,5015,0.9431704885343968,4925,423,5348,0.9209050112191474,-0.022265477315249416,62852,75069
1400000US24013502000,3595,318,3913,0.9187324303603374,3664,148,3812,0.9611752360965372,0.04244280573619985,86076,81723
1400000US24013503000,4927,485,5412,0.9103843311160384,5234,199,5433,0.9633719860114117,0.05298765489537327,69176,82804
1400000US24013504100,5084,405,5489,0.9262160685006376,4878,243,5121,0.9525483304042179,0.02633226190358029,95743,103958
1400000US24013504201,5702,342,6044,0.9434149569821311,5995,200,6195,0.9677158999192897,0.024300942937158676,87768,105308
1400000US24013504202,5566,447,6013,0.9256610676866789,6213,266,6479,0.9589442815249267,0.03328321383824784,103596,109280
1400000US24013505101,4296,209,4505,0.953607103218646,4069,38,4107,0.9907475042610178,0.03714040104237182,119500,127652
1400000US24013505102,5161,163,5324,0.9693839218632607,5517,134,5651,0.9762873827641125,0.00690346090085181,115882,120821
1400000US24013505203,2754,77,2831,0.9728011303426352,2990,132,3122,0.9577194106342088,-0.015081719708426311,100076,102782
1400000US24013505205,3001,63,3064,0.9794386422976501,3475,60,3535,0.983026874115983,0.0035882318183328987,112303,112774
1400000US24013505206,3604,94,3698,0.9745808545159546,3299,90,3389,0.9734434936559457,-0.001137360860008818,87225,91908
1400000US24013505207,3713,60,3773,0.9840975351179433,3791,94,3885,0.9758043758043758,-0.008293159313567444,89750,104577
1400000US24013505208,5423,235,5658,0.9584658890067161,4710,112,4822,0.9767731231854002,0.018307234178684073,83636,106116
1400000US24013506101,4277,178,4455,0.9600448933782267,3938,108,4046,0.9733069698467622,0.0132620764685355,80985,95075
1400000US24013506102,3484,457,3941,0.884039583861964,3949,101,4050,0.9750617283950618,0.09102214453309776,87857,84810
1400000US24013506200,4442,260,4702,0.9447043811144193,4788,102,4890,0.9791411042944785,0.03443672318005919,77645,75238
1400000US24013507500,4605,301,4906,0.9386465552384835,4520,119,4639,0.974347919810304,0.03570136457182049,91971,90093
1400000US24013507601,4059,782,4841,0.8384631274530056,4852,280,5132,0.9454403741231489,0.1069772466701433,83438,66605
1400000US24013507602,3341,348,3689,0.9056654920032529,3811,227,4038,0.9437840515106488,0.038118559507395955,46214,61226
1400000US24013507702,3636,274,3910,0.929923273657289,3592,81,3673,0.9779471821399401,0.048023908482651145,59159,75761
1400000US24013507703,2821,170,2991,0.9431628217987296,2907,90,2997,0.96996996996997,0.026807148171240414,71250,87733
1400000US24013507704,5459,360,5819,0.9381336999484448,5620,377,5997,0.9371352342838085,-9.984656646362389e-4,78319,88306
1400000US24013507801,4953,587,5540,0.894043321299639,5433,204,5637,0.9638105375199574,0.06976721622031834,47287,53010
1400000US24013507802,4206,327,4533,0.927862342819325,4469,96,4565,0.9789704271631983,0.05110808434387326,79963,85208
1400000US24013508101,4397,184,4581,0.9598340973586553,4535,178,4713,0.9622321239125822,0.0023980265539268464,80000,84821
1400000US24013508102,3206,117,3323,0.9647908516400843,2856,47,2903,0.9838098518773682,0.01901900023728398,74375,76083
1400000US24013508200,6498,550,7048,0.9219636776390465,6689,265,6954,0.961892436008053,0.039928758369006445,82141,79797
1400000US24013509001,4138,131,4269,0.9693136565940501,3999,158,4157,0.9619918210247775,-0.007321835569272572,110347,99360
1400000US24013509002,2398,306,2704,0.8868343195266272,2514,211,2725,0.9225688073394496,0.0357344878128224,79375,124250
1400000US24013510000,1034,101,1135,0.9110132158590308,1283,128,1411,0.9092841956059532,-0.00172902025307764,54223,80139
1400000US24013511000,3276,248,3524,0.9296254256526674,3642,70,3712,0.9811422413793104,0.05151681572664302,78689,83625
1400000US24013512000,1460,179,1639,0.8907870652837095,1369,73,1442,0.949375866851595,0.058588801567885485,67917,59188
1400000US24013513001,4335,265,4600,0.9423913043478261,4466,238,4704,0.9494047619047619,0.0070134575569357205,74938,109940
1400000US24013513002,4982,192,5174,0.9628913799768071,5272,185,5457,0.9660985889682976,0.0032072089914905177,120682,129519
1400000US24013514100,3342,259,3601,0.9280755345737295,3584,63,3647,0.982725527831094,0.054649993257364526,99185,122083
1400000US24013514201,4879,411,5290,0.9223062381852551,4812,234,5046,0.9536266349583828,0.0313203967731277,102452,91993
1400000US24013514202,3444,184,3628,0.9492833517089305,3453,75,3528,0.9787414965986394,0.02945814488970888,106029,107961
1400000US24015030100,4585,731,5316,0.8624905944319037,4488,236,4724,0.9500423370025403,0.08755174257063658,52700,68547
1400000US24015030200,4639,487,5126,0.9049941474834179,4582,257,4839,0.9468898532754702,0.04189570579205226,85352,78197
1400000US24015030400,3738,775,4513,0.828273875470862,3935,831,4766,0.8256399496433068,-0.0026339258275551725,40750,32396
1400000US24015030501,3669,286,3955,0.9276864728192162,3833,362,4195,0.9137067938021454,-0.013979679017070867,74321,76797
1400000US24015030503,4570,517,5087,0.8983683900137606,4700,437,5137,0.9149308935176172,0.016562503503856685,49475,63952
1400000US24015030505,3128,399,3527,0.8868726963425007,3836,178,4014,0.955655206776283,0.06878251043378236,55431,56383
1400000US24015030506,7075,929,8004,0.8839330334832584,7437,506,7943,0.9362961097821981,0.05236307629893977,62412,65972
1400000US24015030601,3692,373,4065,0.9082410824108241,3800,116,3916,0.9703779366700716,0.06213685425924742,78375,88115
1400000US24015030602,4790,383,5173,0.9259617243379084,4832,166,4998,0.9667867146858744,0.04082499034796605,79883,82500
1400000US24015030700,4854,442,5296,0.9165407854984894,4837,204,5041,0.959531838920849,0.04299105342235965,76941,84097
1400000US24015030903,3650,543,4193,0.8704984497972812,5482,350,5832,0.9399862825788752,0.06948783278159398,52155,49489
1400000US24015030904,5986,695,6681,0.8959736566382278,7038,73,7111,0.9897342145971031,0.09376055795887528,93156,95865
1400000US24015030905,2666,186,2852,0.9347826086956522,2844,127,2971,0.9572534500168294,0.02247084132117716,58287,80684
1400000US24015030906,8223,738,8961,0.9176431201874791,9647,491,10138,0.9515683566778458,0.03392523649036672,60714,64167
1400000US24015031201,6458,495,6953,0.928807708902632,5612,311,5923,0.9474928245821375,0.018685115679505482,69000,75893
1400000US24015031202,4568,522,5090,0.8974459724950884,5157,211,5368,0.9606929955290611,0.06324702303397267,53818,64188
1400000US24015031301,3354,536,3890,0.8622107969151671,3325,162,3487,0.9535417264123889,0.09133092949722177,69086,85568
1400000US24015031302,6445,387,6832,0.9433548009367682,6691,269,6960,0.9613505747126436,0.017995773775875468,63701,74467
1400000US24015031400,3777,391,4168,0.906190019193858,3730,268,3998,0.9329664832416208,0.026776464047762794,78885,71302
1400000US24017850101,5312,273,5585,0.9511190689346464,5507,331,5838,0.9433025008564577,-0.007816568078188646,91808,89935
1400000US24017850102,2428,296,2724,0.8913362701908958,2236,149,2385,0.9375262054507337,0.046189935259837944,65345,61422
1400000US24017850201,609,83,692,0.88005780346820806,818,7,825,0.9915151515151515,0.1114573480469434,75577,61292
1400000US24017850202,4538,293,4831,0.9393500310494721,4409,302,4711,0.9358947144979834,-0.003455316551488674,65716,56875
1400000US24017850300,2088,116,2204,0.9473684210526315,2006,117,2123,0.9448893075836081,-0.0024791134690234085,89712,72163
1400000US24017850400,3321,336,3657,0.9081214109926169,3490,127,3617,0.9648880287531103,0.05676661776049341,74818,77207
1400000US24017850500,2591,180,2771,0.9350415012630819,2709,89,2798,0.9681915654038599,0.033150064140777924,107750,107875
1400000US24017850600,3864,342,4206,0.9186875891583453,4856,50,4906,0.9898083978801467,0.07112080872180149,106840,104145
1400000US24017850706,4693,404,5097,0.9207376888365705,4960,184,5144,0.9642301710730948,0.043492482236524355,109153,124426
1400000US24017850708,4908,173,5081,0.9659515843337926,5163,156,5319,0.9706711787930062,0.004719594459213661,123164,115179
1400000US24017850709,6360,766,7126,0.8925063149031714,6483,271,6754,0.9598756292567368,0.0673693143535653,77143,86540
1400000US24017850710,5286,296,5582,0.9469724113221067,5390,142,5532,0.9743311641359363,0.0273587528138296,122982,118438
1400000US24017850711,4374,421,4795,0.9122002085505735,4881,193,5074,0.9619629483642097,0.049762739813636214,68311,77310
1400000US24017850712,5390,186,5576,0.9666427546628408,5684,276,5960,0.9536912751677852,-0.012951479495055596,121027,120673
1400000US24017850713,6228,467,6695,0.9302464525765497,7522,199,7721,0.9742261365108147,0.04397968393426499,113011,137202
1400000US24017850801,4508,316,4824,0.9344941956882256,4716,109,4825,0.9774093264248704,0.04291513073664488,107056,110000
1400000US24017850802,3366,454,3820,0.881151832460733,4164,481,4645,0.8964477933261572,0.015295960865424174,68685,73088
1400000US24017850901,5217,524,5741,0.908726702665041,5155,206,5361,0.961574333146801,0.05284763048176,44111,40493
1400000US24017850902,4762,817,5579,0.8535579853020254,5629,177,5806,0.9695142955563211,0.11595631025429565,85797,89777
1400000US24017850904,5317,162,5479,0.9704325606862566,8371,151,8522,0.9822811546585308,0.011848593972274224,106165,106563
1400000US24017850905,4054,354,4408,0.9196914700544465,4078,226,4304,0.9474907063197026,0.027799236265256044,97731,90846
1400000US24017850906,4303,390,4693,0.9168975069252078,4302,144,4446,0.9676113360323887,0.05071382910718092,49967,51536
1400000US24017851001,2561,171,2732,0.9374084919472914,2849,120,2969,0.9595823509599192,0.022173859012627806,96115,82059
1400000US24017851002,8374,519,8893,0.9416394917350726,8292,516,8808,0.94141689373297,-2.2259800210255865e-4,96068,91875
1400000US24033800505,2325,324,2649,0.8776896942242356,2325,117,2442,0.952088452088452,0.07439875786421646,87353,111211
1400000US24033800507,2631,231,2862,0.9192872117400419,3075,145,3220,0.9549689440993789,0.035681732359337026,95505,104792
1400000US24033800509,8369,416,8785,0.9526465566306204,10137,142,10279,0.9861854265979181,0.03353886996729771,101202,104403
1400000US24033800511,4733,222,4955,0.955196770938446,4927,222,5149,0.9568848320062148,0.0016880610677687535,99203,96635
1400000US24033800513,4972,395,5367,0.9264020868269052,5261,250,5511,0.9546361821810924,0.028234095354187194,97173,111480
1400000US24033800514,4415,276,4691,0.9411639309315711,5745,187,5932,0.9684760620364127,0.02731213110484154,170664,157000
1400000US24033800515,3685,307,3992,0.9230961923847696,3795,377,4172,0.9096356663470757,-0.013460526037693876,91364,95682
1400000US24033800516,3276,225,3501,0.9357326478149101,3828,177,4005,0.9558052434456928,0.020072595630782786,85785,88141
1400000US24033800517,4690,270,4960,0.9455645161290323,5797,227,6024,0.9623173970783533,0.016752880949321036,163468,141957
1400000US24033800518,2982,171,3153,0.9457659372026641,3543,146,3689,0.9604228788289509,0.014656941626286835,160300,172061
1400000US24033800519,3668,304,3972,0.9234642497482377,3716,289,4005,0.9278401997503121,0.004375950002074358,110484,104931
1400000US24033800520,1721,161,1882,0.9144527098831031,1787,126,1913,0.9341348667015159,0.019682156818412788,99563,88375
1400000US24033800601,1889,141,2030,0.9305418719211823,1729,162,1891,0.9143310417768377,-0.016210830144344657,103897,76587
1400000US24033800604,1277,200,1477,0.8645903859174001,1805,131,1936,0.9323347107438017,0.06774432482640158,104071,85990
1400000US24033800605,3785,426,4211,0.8988363809071479,4030,136,4166,0.9673547767642823,0.06851839585713437,115000,104313
1400000US24033800606,4142,576,4718,0.8779143704959729,5192,241,5433,0.9556414503957298,0.07772707989975691,80962,92442
1400000US24033800607,5717,495,6212,0.9203155183515775,5491,425,5916,0.9281609195402298,0.00784540118865229,130484,129837
1400000US24033800608,3250,216,3466,0.9376803231390652,4875,177,5052,0.9649643705463183,0.027284047407253098,150899,150375
1400000US24033800701,4762,203,4965,0.9591137965760322,5651,394,6045,0.9348221670802316,-0.02429162949580066,121145,130306
1400000US24033800704,4703,237,4940,0.9520242914979757,4875,175,5050,0.9653465346534653,0.013322243155489577,92298,89188
1400000US24033800705,4049,301,4350,0.9308045977011494,4027,273,4300,0.9365116279069767,0.0057070302058273015,114816,130066
1400000US24033800706,3529,259,3788,0.9316261879619853,3739,114,3853,0.9704126654554892,0.038786477493503946,121029,135568
1400000US24033800707,2522,69,2591,0.9733693554612118,2959,115,3074,0.9625894599869876,-0.0107798954742242,100909,86080
1400000US24033800800,3323,153,3476,0.9559838895281934,3085,430,3515,0.8776671408250356,-0.07831674870315775,104728,116919
1400000US24033800900,1309,151,1460,0.8965753424657534,1342,141,1483,0.9049224544841538,0.008347112018400327,67153,65400
1400000US24033801003,3627,578,4205,0.8625445897740784,5081,404,5485,0.9263445761166819,0.06379998634260342,84900,107917
1400000US24033801004,4040,130,4170,0.9688249400479616,4736,125,4861,0.9742851265171776,0.005460186469215977,112191,129231
1400000US24033801005,3683,362,4045,0.9105067985166873,3968,200,4168,0.9520153550863724,0.04150855656968511,127500,126285
1400000US24033801006,3716,359,4075,0.9119018404907976,3470,131,3601,0.9636212163287976,0.051719375838000015,106681,107656
1400000US24033801104,2270,53,2323,0.977184674989238,2268,16,2284,0.9929947460595446,0.01581007107030663,54107,72862
1400000US24033801207,4155,214,4369,0.9510185397116044,3695,439,4134,0.893807450411224,-0.057211089300380435,129712,110685
1400000US24033801208,3420,229,3649,0.9372430802959715,4244,90,4334,0.9792339640055376,0.04199088370956616,116000,115313
1400000US24033801209,4137,251,4388,0.9427985414767548,4653,302,4955,0.9390514631685166,-0.003747078308238172,98442,102168
1400000US24033801210,3772,630,4402,0.8568832348932304,3947,242,4189,0.9422296490809262,0.08534641418769584,82632,100417
1400000US24033801211,2862,78,2940,0.9734693877551021,2877,204,3081,0.9337877312560857,-0.03968165649901634,96544,99464
1400000US24033801212,2917,438,3355,0.8694485842026826,3098,305,3403,0.9103732001175433,0.04092461591486074,93560,101029
1400000US24033801213,3208,375,3583,0.89533910131175,3515,268,3783,0.929156753899022,0.033817652587271985,88209,109196
1400000US24033801214,3445,292,3737,0.9218624565159219,3892,551,4443,0.8759846950258834,-0.04587776149003853,83132,71940
1400000US24033801215,2131,153,2284,0.9330122591943958,2471,253,2724,0.9071218795888399,-0.025890379605555847,106658,104779
1400000US24033801216,2814,424,3238,0.8690549722050649,3619,167,3786,0.9558901215002641,0.0868351492951992,85357,107979
1400000US24033801217,3207,318,3525,0.9097872340425532,3244,156,3400,0.9541176470588235,0.044330413016270276,103250,124609
1400000US24033801302,2559,126,2685,0.9530726256983241,2730,107,2837,0.9622841029256256,0.009211477227301534,113125,123822
1400000US24033801305,5010,490,5500,0.9109090909090909,5337,995,6332,0.8428616550852811,-0.06804743582380979,97045,122091
1400000US24033801307,3454,265,3719,0.9287442860984135,3616,183,3799,0.9518294287970519,0.023085142698638372,128718,111786
1400000US24033801308,3641,261,3902,0.933111225012814,3529,396,3925,0.8991082802547771,-0.03400294475803689,112773,114167
1400000US24033801309,3553,292,3845,0.9240572171651495,3310,89,3399,0.9738158281847602,0.049758611019610655,127700,139702
1400000US24033801310,5677,203,5880,0.9654761904761905,6084,261,6345,0.9588652482269504,-0.0066109422492400816,138670,114087
1400000US24033801311,5338,710,6048,0.8826058201058201,6690,267,6957,0.9616213885295386,0.07901556842371849,97237,115492
1400000US24033801312,3012,379,3391,0.8882335594219994,3778,207,3985,0.9480552070263488,0.05982164760434938,81518,89036
1400000US24033801313,2828,185,3013,0.9385994025887819,3258,154,3412,0.9548651817116061,0.01626577912282412,115833,102159
1400000US24033801404,4057,719,4776,0.8494556113902848,4233,516,4749,0.8913455464308275,0.041889935040542725,73633,80349
1400000US24033801405,3574,1533,5107,0.699823771294302,3946,715,4661,0.8465994421797898,0.14677567088548782,64605,67359
1400000US24033801406,2342,356,2698,0.8680504077094143,2532,134,2666,0.9497374343585896,0.08168702664917527,65297,80357
1400000US24033801407,5655,585,6240,0.90625,5920,844,6764,0.8752217622708457,-0.031028237729154307,85321,86813
1400000US24033801408,3721,136,3857,0.9647394347938812,2971,288,3259,0.9116293341515802,-0.05311010064230104,64053,61573
1400000US24033801409,2596,316,2912,0.8914835164835165,2878,226,3104,0.9271907216494846,0.03570720516596804,55495,75568
1400000US24033801410,3232,351,3583,0.902037398827798,2826,358,3184,0.8875628140703518,-0.01447458475744623,112340,102153
1400000US24033801411,3186,236,3422,0.9310344827586207,2833,576,3409,0.8310354942798475,-0.0999989884787732,91583,91673
1400000US24033801500,1795,354,2149,0.8352722196370405,2284,366,2650,0.8618867924528302,0.026614572815789717,71645,77667
1400000US24033801600,2164,250,2414,0.8964374482187241,2116,362,2478,0.8539144471347861,-0.04252300108393792,51623,42338
1400000US24033801701,3436,385,3821,0.8992410363779115,4122,373,4495,0.9170189098998888,0.01777787352197724,68663,65547
1400000US24033801702,3371,497,3868,0.8715098241985523,3493,531,4024,0.8680417495029821,-0.0034680746955702,54111,70797
1400000US24033801704,5232,629,5861,0.8926804299607576,5350,535,5885,0.9090909090909091,0.01641047913015148,55413,50063
1400000US24033801706,1284,381,1665,0.7711711711711712,1449,142,1591,0.9107479572595851,0.13957678608841395,64659,69821
1400000US24033801707,4889,1151,6040,0.8094370860927153,5190,1833,7023,0.739000427167877,-0.0704366589248383,59844,52381
1400000US24033801708,2877,889,3766,0.7639405204460966,2926,438,3364,0.8697978596908442,0.1058573392447476,63867,54468
1400000US24033801801,1860,365,2225,0.8359550561797753,1733,245,1978,0.8761375126390293,0.040182456459254,48036,45425
1400000US24033801802,2778,470,3248,0.8552955665024631,3370,248,3618,0.9314538419016031,0.07615827539914,51538,47457
1400000US24033801804,1701,330,2031,0.8375184638109305,1900,239,2139,0.8882655446470313,0.0507470808361008,75950,80476
1400000US24033801805,2038,421,2459,0.8287921919479463,2162,261,2423,0.8922822946760215,0.0634901027280752,50788,54871
1400000US24033801807,3896,398,4294,0.9073125291103866,4459,304,4763,0.9361746798236406,0.02886215071325393,58408,65460
1400000US24033801808,3162,550,3712,0.8518318965517241,3563,401,3964,0.8988395560040363,0.04700765945231222,55378,58839
1400000US24033801901,4575,341,4916,0.9306346623270952,4291,400,4691,0.9147303346834363,-0.0159043276436589,90750,83333
1400000US24033801904,2614,708,3322,0.7868753762793498,2560,356,2916,0.877914951989026,0.09103957570967625,59498,49643
1400000US24033801905,4373,691,5064,0.8635466034755134,5051,246,5297,0.9535586180857089,0.09001201461019548,90598,93388
1400000US24033801906,1684,359,2043,0.824278022515908,1565,196,1761,0.8886996024985804,0.0644215799826724,63267,56806
1400000US24033801907,2956,293,3249,0.909818405663281,2522,201,2723,0.9261843554902681,0.016365949826987136,57475,54564
1400000US24033801908,3197,382,3579,0.8932662754959486,2907,398,3305,0.8795763993948563,-0.013689876101092291,57778,61080
1400000US24033802001,4714,741,5455,0.8641613198900092,5448,855,6303,0.8643503093764874,1.8898948647816383e-4,53809,63185
1400000US24033802002,3344,433,3777,0.8853587503309505,3571,446,4017,0.8889718695543938,0.0036131192234433174,71042,74125
1400000US24033802103,2750,181,2931,0.9382463323097919,2983,324,3307,0.9020260054429997,-0.03622032686679222,83008,85563
1400000US24033802104,1453,187,1640,0.8859756097560976,1727,158,1885,0.9161803713527852,0.030204761596687613,42333,67414
1400000US24033802106,3325,656,3981,0.8352172820899272,3367,489,3856,0.8731846473029046,0.03796736521297739,52700,47768
1400000US24033802107,3499,682,4181,0.8368811289165271,3398,267,3665,0.9271487039563437,0.09026757503981664,54609,55779
1400000US24033802201,1314,324,1638,0.8021978021978022,1768,240,2008,0.8804780876494024,0.07828028545160015,59643,70000
1400000US24033802203,3380,915,4295,0.7869615832363213,3940,398,4338,0.9082526509912402,0.12129106775491894,51068,61648
1400000US24033802204,5228,581,5809,0.8999827853331038,5872,387,6259,0.9381690365873143,0.03818625125421049,79086,84450
1400000US24033802301,3507,578,4085,0.8585067319461445,3633,303,3936,0.9230182926829268,0.06451156073678233,83700,69152
1400000US24033802404,4060,389,4449,0.9125646212632053,3562,371,3933,0.9056699720315281,-0.006894649231677152,50094,43350
1400000US24033802405,3565,380,3945,0.9036755386565273,3585,231,3816,0.9394654088050315,0.03578987014850421,52129,61865
1400000US24033802406,2026,301,2327,0.8706489041684572,2019,195,2214,0.9119241192411924,0.04127521507273524,56964,54963
1400000US24033802407,3644,461,4105,0.8876979293544458,3162,226,3388,0.9332939787485242,0.04559604939407835,50810,51712
1400000US24033802408,1237,272,1509,0.8197481776010603,1486,189,1675,0.8871641791044776,0.06741600150341731,43314,51958
1400000US24033802501,2573,332,2905,0.8857142857142857,2587,144,2731,0.9472720615159282,0.06155777580164257,53565,56167
1400000US24033802502,2195,392,2587,0.8484731349052957,2245,348,2593,0.86579251831855,0.01731938341325423,71190,63704
1400000US24033802600,2585,318,2903,0.8904581467447468,2981,573,3554,0.8387732132808103,-0.05168493346393643,53136,57284
1400000US24033802700,1883,462,2345,0.8029850746268656,2644,509,3153,0.8385664446558833,0.03558137002901762,47833,58403
1400000US24033802803,4119,242,4361,0.9445081403347856,5162,559,5721,0.9022898094738682,-0.04221833086091742,54840,62095
1400000US24033802804,4859,487,5346,0.9089038533482978,4967,384,5351,0.9282377125770884,0.019333859228790606,66769,62308
1400000US24033802805,4231,698,4929,0.8583891255832826,3875,427,4302,0.900743840074384,0.0423547144911014,59500,67667
1400000US24033802901,3284,427,3711,0.884936674750741,3799,422,4221,0.9000236910684671,0.015087016317726132,44984,47260
1400000US24033803001,2278,493,2771,0.8220858895705522,2467,469,2936,0.840258855585831,0.018172966015278846,69125,67000
1400000US24033803002,2599,135,2734,0.9506217995610826,2470,86,2556,0.9663536776212832,0.0157318780602006,64145,65461
1400000US24033803100,2035,251,2286,0.8902012248468941,2552,231,2783,0.9169960474308301,0.02679482258393595,61214,53800
1400000US24033803200,2526,507,3033,0.8328387734915925,2348,388,2736,0.8581871345029239,0.02534836101133142,52000,52675
1400000US24033803300,3938,515,4453,0.8843476308106895,3602,811,4413,0.8162247903920236,-0.0681228404186659,63375,54989
1400000US24033803401,1111,310,1421,0.7818437719915552,964,269,1233,0.7818329278183292,-1.0844173225943443e-5,49375,50481
1400000US24033803402,3915,521,4436,0.8825518485121732,4426,254,4680,0.9457264957264957,0.06317464721432253,55000,43657
1400000US24033803508,3767,821,4588,0.8210549258936356,3429,623,4052,0.846248766041461,0.02519384014782544,42764,83831
1400000US24033803509,2418,606,3024,0.7996031746031746,2400,613,3013,0.7965482907401261,-0.0030548838630485298,44873,44516
1400000US24033803512,5284,595,5879,0.8987923116176221,6420,505,6925,0.9270758122743682,0.02828350065674612,85567,94191
1400000US24033803513,3846,435,4281,0.8983882270497547,4406,412,4818,0.9144873391448733,0.016099112095118606,73393,72244
1400000US24033803514,4189,177,4366,0.9594594594594594,4039,198,4237,0.953268822279915,-0.006190637179544378,84792,79506
1400000US24033803516,4181,455,4636,0.9018550474547024,4765,97,4862,0.9800493624023036,0.0781943149476012,106172,126509
1400000US24033803519,3577,338,3915,0.9136653895274585,5450,179,5629,0.9682003908331853,0.05453500130572686,79100,91389
1400000US24033803520,3446,387,3833,0.8990346986694495,4009,322,4331,0.925652274301547,0.026617575632097434,106438,119479
1400000US24033803521,4225,398,4623,0.9139087172831495,5606,278,5884,0.9527532290958531,0.03884451181270365,103357,124125
1400000US24033803522,3431,206,3637,0.9433599120153973,3374,254,3628,0.9299889746416758,-0.013370937373721414,103438,100317
1400000US24033803523,3533,413,3946,0.8953370501773948,3866,155,4021,0.9614523750310868,0.06611532485369198,125104,128594
1400000US24033803524,3427,314,3741,0.9160652232023523,3707,506,4213,0.8798955613577023,-0.03616966184464998,81696,72218
1400000US24033803525,2154,387,2541,0.8476977567886659,1788,206,1994,0.8966900702106319,0.04899231342196597,52721,60635
1400000US24033803526,3034,313,3347,0.9064834179862563,3062,184,3246,0.9433148490449784,0.03683143105872211,77969,84350
1400000US24033803527,2904,308,3212,0.9041095890410958,3119,224,3343,0.9329943164822017,0.028884727441105817,99914,86389
1400000US24033803601,3625,258,3883,0.9335565284573784,3512,389,3901,0.9002819789797488,-0.033274549477629534,95357,89286
1400000US24033803602,1713,183,1896,0.9034810126582279,2397,138,2535,0.9455621301775148,0.04208111751928689,66288,61538
1400000US24033803605,5610,1354,6964,0.805571510626077,5952,1121,7073,0.8415099674819737,0.035938456855896694,78696,79110
1400000US24033803606,4446,507,4953,0.8976377952755905,4529,823,5352,0.8462257100149477,-0.05141208526064278,78750,72806
1400000US24033803607,3194,279,3473,0.9196659948171609,3044,508,3552,0.8569819819819819,-0.06268401283517899,107292,85714
1400000US24033803608,4252,1030,5282,0.8049981067777358,5260,915,6175,0.8518218623481781,0.04682375557044238,62025,74036
1400000US24033803610,2022,832,2854,0.708479327259986,2985,688,3673,0.8126871766947998,0.10420784943481387,50346,67167
1400000US24033803612,2517,466,2983,0.8437814280925243,2870,439,3309,0.867331520096706,0.023550092004181677,49783,60299
1400000US24033803613,3747,1092,4839,0.7743335399876008,4441,1192,5633,0.7883898455529913,0.014056305565390503,52482,57645
1400000US24033803700,2083,509,2592,0.8036265432098766,2353,423,2776,0.8476224783861671,0.043995935176290524,62143,70446
1400000US24033803801,1900,608,2508,0.7575757575757576,1957,514,2471,0.7919870497774181,0.034411292201660504,67143,76500
1400000US24033803803,4198,1101,5299,0.7922249481034157,5460,765,6225,0.8771084337349397,0.08488348563152404,65970,65917
1400000US24033803900,2398,1736,4134,0.5800677310111272,2383,1448,3831,0.6220308013573479,0.04196307034622071,69000,67083
1400000US24033804001,4159,1080,5239,0.7938537888910098,4172,745,4917,0.8484848484848485,0.05463105959383874,40663,35853
1400000US24033804002,2572,1371,3943,0.6522952066954096,3359,941,4300,0.7811627906976745,0.12886758400226483,55847,62215
1400000US24033804101,2718,458,3176,0.8557934508816121,3178,319,3497,0.9087789533886188,0.05298550250700673,72083,70938
1400000US24033804102,4817,1099,5916,0.8142325895875592,4984,932,5916,0.8424611223799865,0.02822853279242732,53490,67773
1400000US24033804200,2676,224,2900,0.9227586206896552,2940,174,3114,0.9441233140655106,0.021364693375855448,100000,117665
1400000US24033804300,2713,948,3661,0.741054356733133,2693,809,3502,0.7689891490576813,0.02793479232454832,40417,46773
1400000US24033804400,2046,570,2616,0.7821100917431193,2233,549,2782,0.8026599568655644,0.020549865122445055,60034,59911
1400000US24033804600,2094,861,2955,0.7086294416243655,2509,645,3154,0.7954977805960685,0.08686833897170299,46083,78798
1400000US24033804700,2621,943,3564,0.7354096520763187,2971,387,3358,0.8847528290649196,0.1493431769886009,80147,74783
1400000US24033804801,1786,446,2232,0.8001792114695341,2057,478,2535,0.811439842209073,0.011260630739538868,40444,41455
1400000US24033804802,1569,1413,2982,0.5261569416498993,2247,830,3077,0.7302567435814105,0.20409980193151112,36838,53082
1400000US24033804900,3249,634,3883,0.8367241823332475,2916,705,3621,0.8053024026512013,-0.03142177968204618,52853,69190
1400000US24033805000,4098,1444,5542,0.7394442439552508,4716,856,5572,0.8463747307968413,0.10693048684159057,70407,53778
1400000US24033805101,2206,1611,3817,0.5779407911972754,3105,1021,4126,0.7525448376151236,0.1746040464178482,49228,51250
1400000US24033805201,3224,1175,4399,0.73289383950897935,3447,1583,5030,0.6852882703777335,-0.047605569131245806,50318,51172
1400000US24033805202,2585,1039,3624,0.7133002207505519,2876,901,3777,0.7614508869473127,0.04815066619676078,53494,55824
1400000US24033805500,2360,1855,4215,0.5599051008303677,2527,1370,3897,0.6484475237362073,0.08854242290583958,74310,49917
1400000US24033805601,2043,4715,6758,0.3023083752589524,2880,3740,6620,0.4350453172205438,0.13273694196159141,39620,50271
1400000US24033805602,1785,3927,5712,0.3125,2215,3346,5561,0.3983096565365941,0.08580965653659411,53276,72574
1400000US24033805700,3649,2341,5990,0.6091819699499166,3881,2140,6021,0.6445773127387477,0.03539534278883116,54222,58421
1400000US24033805801,2794,1774,4568,0.611646234676007,3719,1015,4734,0.7855935783692438,0.17394734369323683,78295,103194
1400000US24033805802,2586,1610,4196,0.6163012392755005,2681,1471,4152,0.6457129094412332,0.02941167016573265,65909,66473
1400000US24033805904,2474,679,3153,0.7846495401205201,2429,737,3166,0.7672141503474416,-0.01743538977307857,55603,74107
1400000US24033805906,2003,1078,3081,0.6501135994806881,2241,1058,3299,0.6792967565929069,0.02918315711221875,48905,55781
1400000US24033805907,2315,1416,3731,0.6204770838917181,2693,1375,4068,0.6619960668633235,0.04151898297160539,54090,60985
1400000US24033805908,1707,1198,2905,0.5876075731497419,1529,669,2198,0.6956323930846224,0.10802481993488056,49758,56469
1400000US24033805909,3435,1053,4488,0.7653743315508021,4146,767,4913,0.8438835741909221,0.07850924264011994,44978,64441
1400000US24033806000,3348,2045,5393,0.620804746894122,3840,1250,5090,0.7544204322200393,0.13361568532591728,53732,71576
1400000US24033806100,3276,715,3991,0.8208469055374593,3736,484,4220,0.885308056872038,0.06446115133457864,62792,76922
1400000US24033806200,3030,828,3858,0.7853810264385692,3644,267,3911,0.9317310150856558,0.1463499886470866,76771,74821
1400000US24033806300,1433,544,1977,0.7248356095093577,2060,448,2508,0.8213716108452951,0.09653600133593743,54732,78258
1400000US24033806400,3325,163,3488,0.9532683486238532,3382,133,3515,0.9621621621621622,0.008893813538308981,134868,130893
1400000US24033806501,3466,1973,5439,0.6372494943923516,3421,2025,5446,0.6281674623576937,-0.00908203203465785,52520,58929
1400000US24033806601,2748,1835,4583,0.5996072441632119,2671,1613,4284,0.6234827264239029,0.023875482260691028,54708,47939
1400000US24033806602,3618,1039,4657,0.7768949967790423,4426,1252,5678,0.7794998238816485,0.002604827102606233,59282,70806
1400000US24510110100,2663,508,3171,0.8397981709239988,2870,170,3040,0.944078947368421,0.10428077644442224,40996,49411
1400000US24510110200,4800,458,5258,0.9128946367440092,5053,215,5268,0.9591875474563402,0.04629291071233099,34141,42167
1400000US24510120100,4641,104,4745,0.9780821917808219,4469,133,4602,0.9710995219469796,-0.006982669833842325,59107,62266
1400000US24510120201,2015,169,2184,0.9226190476190477,1873,113,1986,0.9431017119838873,0.020482664364839587,55034,73625
1400000US24510120202,6652,356,7008,0.9492009132420092,5816,214,6030,0.9645107794361526,0.015309866194143429,25373,36552
1400000US24510120300,2852,314,3166,0.9008212255211624,3680,261,3941,0.9337731540218219,0.03295192850065953,39472,49628
1400000US24510120400,1115,232,1347,0.8277654046028211,1539,165,1704,0.903169014084507,0.0754036094816859,38214,38194
1400000US24510120500,1647,406,2053,0.8022406234778373,2096,211,2307,0.9085392284351972,0.10629860495735988,33906,52596
1400000US24510120600,2164,355,2519,0.8590710599444223,2227,216,2443,0.9115841178878428,0.05251305794342043,16505,20164
1400000US24510120700,1951,288,2239,0.8713711478338544,2045,159,2204,0.927858439201452,0.05648729136759756,51250,57381
1400000US24510130100,2245,425,2670,0.8408239700374532,2578,168,2746,0.9388201019664967,0.09799613192904344,21875,28095
1400000US24510130200,3124,401,3525,0.886241134751773,2976,213,3189,0.9332079021636877,0.046966767411914634,34789,46086
1400000US24510130300,1906,258,2164,0.8807763401109058,2295,151,2446,0.9382665576451349,0.057490217534229116,35000,34118
1400000US24510130400,1575,266,1841,0.8555133079847909,2001,173,2174,0.9204231830726771,0.06490987508788626,29040,27393
1400000US24510130600,3393,493,3886,0.8731343283582089,3496,186,3682,0.9494839760999457,0.0763496477417368,58030,89363
1400000US24510130700,4276,602,4878,0.8765887658876589,4366,114,4480,0.9745535714285715,0.09796480554091258,53796,57368
1400000US24510130803,2278,225,2503,0.9101078705553336,2267,149,2416,0.9383278145695364,0.028219944014202802,56434,55398
1400000US24510130804,1494,396,1890,0.7904761904761904,1791,151,1942,0.9222451081359423,0.13176891765975185,51667,65188
1400000US24510130805,1013,67,1080,0.937962962962963,849,57,906,0.9370860927152318,-8.768702477311985e-4,50333,49545
1400000US24510130806,1228,151,1379,0.8905003625815808,1122,84,1206,0.9303482587064676,0.03984789612488682,54297,84444
1400000US24510140100,4983,174,5157,0.9662594531704479,4300,384,4684,0.9180187873612298,-0.04824066580921815,34859,50750
1400000US24510140200,2402,317,2719,0.8834130194924604,2464,227,2691,0.9156447417316983,0.03223172223923787,15265,24282
1400000US24510140300,2095,354,2449,0.8554512045732953,2637,219,2856,0.9233193277310925,0.06786812315779722,19722,27337
1400000US24510150100,2398,777,3175,0.7552755905511811,2383,295,2678,0.8898431665421956,0.13456757599101454,17270,20269
1400000US24510150200,2305,469,2774,0.830930064888248,2251,322,2573,0.8748542557326079,0.043924190844359834,25156,40313
1400000US24510150300,1888,676,2564,0.7363494539781591,1875,242,2117,0.8856872933396316,0.1493378393614725,30377,38617
1400000US24510150400,2956,423,3379,0.8748150340337378,3410,339,3749,0.9095758869031741,0.03476085286943631,35739,32868
1400000US24510150500,1842,389,2231,0.8256387270282385,1432,150,1582,0.9051833122629582,0.07954458523471974,29500,34583
1400000US24510150600,1851,531,2382,0.7770780856423174,2700,222,2922,0.9240246406570842,0.14694655501476683,22188,26782
1400000US24510150701,1324,93,1417,0.9343683839096684,1421,126,1547,0.918552036199095,-0.015816347710573386,47019,45357
1400000US24510150702,1508,337,1845,0.8173441734417344,2101,84,2185,0.9615560640732266,0.1442118906314922,44250,40529
1400000US24510150800,3526,541,4067,0.866978116547824,3994,305,4299,0.9290532682019074,0.062075151654083394,34530,35095
1400000US24510150900,1891,455,2346,0.8060528559249787,3001,326,3327,0.9020138262699129,0.09596097034493423,40583,54410
1400000US24510151000,3990,772,4762,0.8378832423351533,4210,423,4633,0.9086984675156486,0.07081522518049532,30589,39369
1400000US24510151100,5862,1099,6961,0.8421203850021549,6314,588,6902,0.9148073022312373,0.07268691722908238,41918,46389
1400000US24510151200,4369,539,4908,0.8901792991035045,4249,494,4743,0.8958465106472696,0.005667211543765149,13635,20276
1400000US24510151300,4357,690,5047,0.863285119873192,4011,294,4305,0.9317073170731708,0.06842219719997877,30845,26538
1400000US24510160100,2034,455,2489,0.8171956609079952,1788,210,1998,0.8948948948948949,0.07769923398689971,18028,25772
1400000US24510160200,2309,377,2686,0.8596425912137007,2224,165,2389,0.9309334449560486,0.07129085374234789,35167,26331
1400000US24510160300,1309,152,1461,0.8959616700889802,952,84,1036,0.918918918918919,0.02295724882993877,24447,21017
1400000US24510160400,2513,533,3046,0.8250164149704531,2253,199,2452,0.9188417618270799,0.0938253468566268,31912,23417
1400000US24510160500,3070,417,3487,0.8804129624318898,4179,426,4605,0.9074918566775244,0.027078894245634588,29438,36333
1400000US24510160600,2204,457,2661,0.8282600526118,3015,359,3374,0.8935981031416717,0.06533805052987163,23411,33586
1400000US24510160700,4045,671,4716,0.8577184054283291,3906,405,4311,0.906054279749478,0.04833587432114894,28725,36097
1400000US24510160801,2695,773,3468,0.7771049596309112,2882,246,3128,0.9213554987212276,0.14425053909031638,42564,40260
1400000US24510160802,2617,730,3347,0.7818942336420676,2935,434,3369,0.8711783912140101,0.08928415757194252,30417,42297
1400000US24510170100,1274,298,1572,0.8104325699745547,1445,174,1619,0.8925262507720816,0.08209368079752688,33065,27000
1400000US24510170200,3367,243,3610,0.9326869806094182,2749,284,3033,0.9063633366303989,-0.026323643979019318,9608,14707
1400000US24510170300,1949,209,2158,0.9031510658016683,1544,86,1630,0.947239263803681,0.04408819800201269,20292,22574
1400000US24510180100,1798,275,2073,0.8673420164013507,2133,120,2253,0.9467376830892144,0.07939566668786369,15625,15662
1400000US24510180200,793,129,922,0.8600867678958786,647,156,803,0.8057285180572852,-0.05435824983859339,16302,22778
1400000US24510180300,1371,244,1615,0.8489164086687306,1526,125,1651,0.9242883101150817,0.07537190144635109,24531,36458
1400000US24510190100,1826,250,2076,0.8795761078998073,1878,179,2057,0.912980068060282,0.033403960160474644,31341,20000
1400000US24510190200,1644,327,1971,0.8340943683409436,1655,222,1877,0.8817261587639851,0.04763179042304144,44375,36875
1400000US24510190300,1272,473,1745,0.7289398280802293,2075,317,2392,0.8674749163879598,0.13853508830773054,17320,20352
1400000US24510200100,1507,367,1874,0.804162219850587,1580,151,1731,0.9127671865973426,0.10860496674675557,32045,32636
1400000US24510200200,1767,233,2000,0.8835,2500,118,2618,0.9549274255156608,0.07142742551566084,25385,29974
1400000US24510200300,1525,289,1814,0.840683572216097,1486,126,1612,0.9218362282878412,0.08115265607174416,21726,21890
1400000US24510200400,1508,320,1828,0.824945295404814,1469,80,1549,0.9483537766300839,0.12340848122526993,30383,30365
1400000US24510200500,2302,722,3024,0.7612433862433863,2420,523,2943,0.8222901800883452,0.061046793844958924,30246,20982
1400000US24510200600,2356,595,2951,0.7983734327346662,2159,140,2299,0.9391039582427142,0.140730525508048,31514,33550
1400000US24510200701,3612,297,3909,0.9240214888718342,4821,646,5467,0.8818364733857692,-0.042185015486065014,35169,37194
1400000US24510200702,1236,137,1373,0.9002184996358339,1005,95,1100,0.9136363636363637,0.0134178640005298,30313,27328
1400000US24510200800,1962,357,2319,0.8460543337645536,1887,177,2064,0.9142441860465116,0.06818985228195795,28826,38750
1400000US24510210100,1772,278,2050,0.864390243902439,2248,126,2374,0.9469250210614996,0.08253477715906055,52951,44583
1400000US24510210200,2993,571,3564,0.8397867564534232,2638,387,3025,0.8720661157024794,0.03227935924905623,42532,32000
1400000US24510220100,3562,180,3742,0.9518973810796365,4053,238,4291,0.9445350734094616,-0.007362307670174872,59309,69245
1400000US24510230100,1920,68,1988,0.96579476861167,1718,104,1822,0.9429198682766191,-0.022874900335050907,65833,61563
1400000US24510230200,1752,158,1910,0.9172774869109948,2103,63,2166,0.9709141274238227,0.053636640512827904,76397,105511
1400000US24510230300,783,182,965,0.81139896373057,1266,34,1300,0.9738461538461538,0.16244719011558384,49479,103889
1400000US24510240100,2427,147,2574,0.9428904428904429,3032,35,3067,0.9885881969351158,0.04569775404467291,105833,119353
1400000US24510240200,2546,141,2687,0.9475251209527354,3170,40,3210,0.9875389408099688,0.0400138198572334,111167,126597
1400000US24510240300,1816,96,1912,0.9497907949790795,1949,84,2033,0.9586817511067388,0.008890956127659333,114844,115078
1400000US24510240400,2438,174,2612,0.9333843797856048,2707,164,2871,0.9428770463253222,0.009492666539717365,82568,102107
1400000US24510250101,3412,414,3826,0.8917929952953476,4126,182,4308,0.957753017641597,0.06596002234624943,47633,54853
1400000US24510250102,2501,357,2858,0.8750874737578727,3153,97,3250,0.9701538461538461,0.09506637239597349,31014,48950
1400000US24510250103,3290,641,3931,0.8369371661154923,2988,208,3196,0.934918648310388,0.09798148219489566,40027,38109
1400000US24510250203,2045,259,2304,0.8875868055555556,1676,262,1938,0.8648090815273478,-0.02277772402820777,34844,38009
1400000US24510250204,4382,557,4939,0.8872241344401701,3846,191,4037,0.9526876393361406,0.06546350489597053,13297,14520
1400000US24510250205,3751,1089,4840,0.775,3830,567,4397,0.8710484421196271,0.09604844211962704,45829,40453
1400000US24510250206,2000,515,2515,0.7952286282306164,1711,310,2021,0.8466105888174171,0.05138196058680078,56667,53079
1400000US24510250207,2294,370,2664,0.8611111111111112,1907,186,2093,0.9111323459149546,0.05002123480384346,31425,30688
1400000US24510250301,2319,266,2585,0.8970986460348163,2203,145,2348,0.9382453151618398,0.04114666912702358,29777,28917
1400000US24510250303,1491,544,2035,0.7326781326781326,1942,279,2221,0.8743809095002252,0.14170277682209254,40870,33833
1400000US24510250401,2834,571,3405,0.8323054331864904,2950,547,3497,0.8435802116099513,0.011274778423460918,33333,41622
1400000US24510250402,4605,1142,5747,0.8012876283278232,3765,467,4232,0.8896502835538752,0.08836265522605202,29635,42163
1400000US24510250500,3674,1150,4824,0.761608623548922,4631,540,5171,0.8955714561980275,0.13396283264910547,37599,37258
1400000US24510250600,0,0,0,NaN,0,0,0,NaN,NaN,NA,NA
1400000US24510260101,4219,757,4976,0.8478697749196141,4157,568,4725,0.8797883597883598,0.03191858486874566,44466,50981
1400000US24510260102,4504,571,5075,0.887487684729064,4535,207,4742,0.9563475326866301,0.06885984795756606,50588,52560
1400000US24510260201,4320,668,4988,0.8660785886126704,4379,539,4918,0.8904026026840179,0.024324014071347544,39737,34417
1400000US24510260202,4582,1068,5650,0.8109734513274336,5430,355,5785,0.9386343993085566,0.12766094798112304,26724,38347
1400000US24510260203,2170,412,2582,0.8404337722695585,2684,350,3034,0.8846407382992749,0.04420696602971641,33808,37500
1400000US24510260301,4060,513,4573,0.8878198119396458,4348,301,4649,0.9352548935254894,0.04743508158584364,44904,37409
1400000US24510260302,5403,1068,6471,0.8349559573481687,6013,544,6557,0.9170352295256977,0.08207927217752897,49961,31097
1400000US24510260303,523,104,627,0.8341307814992025,852,95,947,0.8996832101372756,0.06555242863807309,18052,17898
1400000US24510260401,2391,888,3279,0.7291857273559011,3107,426,3533,0.8794225870365129,0.15023685968061173,25567,32105
1400000US24510260402,2198,217,2415,0.9101449275362319,2808,169,2977,0.9432314410480349,0.03308651351180303,40994,42231
1400000US24510260403,1788,348,2136,0.8370786516853933,1726,114,1840,0.9380434782608695,0.10096482657547623,37984,31657
1400000US24510260404,1415,959,2374,0.5960404380791913,1604,673,2277,0.7044356609574001,0.1083952228782088,43844,35900
1400000US24510260501,3461,1524,4985,0.6942828485456369,4451,1278,5729,0.7769244196194799,0.08264157107384296,44113,53911
1400000US24510260604,946,204,1150,0.8226086956521739,1299,136,1435,0.9052264808362369,0.08261778518406304,22594,22027
1400000US24510260605,3745,851,4596,0.8148389904264578,3846,747,4593,0.83736120182887,0.022522211402412173,34769,37326
1400000US24510260700,1311,1035,2346,0.5588235294117647,2086,605,2691,0.7751765143069491,0.2163529848951844,34429,56818
1400000US24510260800,1698,1171,2869,0.5918438480306727,1805,899,2704,0.6675295857988166,0.07568573776814391,35674,44519
1400000US24510260900,2037,406,2443,0.833810888252149,3034,76,3110,0.9755627009646303,0.14175181271248127,80282,99932
1400000US24510261000,1949,1148,3097,0.6293186955117857,2489,588,3077,0.8089047773805654,0.17958608186877978,40732,53194
1400000US24510261100,1678,160,1838,0.9129488574537541,1742,67,1809,0.9629629629629629,0.05001410550920882,95347,111458
1400000US24510270101,1540,285,1825,0.8438356164383561,1464,104,1568,0.9336734693877551,0.08983785294939894,60409,65469
1400000US24510270102,3166,372,3538,0.894855850763143,3427,485,3912,0.8760224948875256,-0.018833355875617408,50563,66581
1400000US24510270200,1616,189,1805,0.8952908587257618,1586,177,1763,0.8996029495178672,0.004312090792105483,64697,68036
1400000US24510270301,2522,344,2866,0.8799720865317515,2680,252,2932,0.9140518417462483,0.0340797552144968,57813,67379
1400000US24510270302,1328,256,1584,0.8383838383838383,1675,162,1837,0.9118127381600436,0.07342889977620526,65893,68839
1400000US24510270401,4417,415,4832,0.914114238410596,5860,194,6054,0.9679550710274198,0.05384083261682382,56798,61786
1400000US24510270402,2763,350,3113,0.887568262126566,3234,162,3396,0.9522968197879859,0.06472855766141983,66152,72759
1400000US24510270501,4238,198,4436,0.9553651938683498,3846,133,3979,0.966574516210103,0.011209322341753203,69788,59167
1400000US24510270502,3829,460,4289,0.892748892515738,4098,156,4254,0.9633286318758815,0.0705797393601435,58902,64375
1400000US24510270600,3722,446,4168,0.8929942418426103,4737,145,4882,0.9702990577632118,0.07730481592060146,58768,58972
1400000US24510270701,2323,494,2817,0.8246361377351793,2255,399,2654,0.8496608892238131,0.025024751488633812,32231,42176
1400000US24510270702,1570,555,2125,0.7388235294117647,1806,151,1957,0.9228410832907511,0.18401755387898644,42162,50651
1400000US24510270703,2636,363,2999,0.8789596532177393,2386,227,2613,0.9131266743207042,0.03416702110296488,66250,63448
1400000US24510270801,4112,542,4654,0.883541039965621,3681,503,4184,0.8797801147227533,-0.003760925242867641,53193,52546
1400000US24510270802,4564,760,5324,0.8572501878287002,5280,458,5738,0.9201812478215406,0.06293105999284043,44192,50084
1400000US24510270803,5372,765,6137,0.8753462603878116,6767,208,6975,0.970179211469534,0.0948329510817224,43153,52900
1400000US24510270804,2571,515,3086,0.8331173039533376,2815,357,3172,0.887452711223203,0.05433540726986541,43684,51268
1400000US24510270805,4498,510,5008,0.8981629392971247,4772,490,5262,0.9068795134929685,0.008716574195843818,43481,56412
1400000US24510270901,3600,695,4295,0.8381839348079162,3997,193,4190,0.9539379474940334,0.11575401268611718,48125,51355
1400000US24510270902,4110,512,4622,0.889225443530939,5378,231,5609,0.9588161882688536,0.0695907447379146,63258,62946
1400000US24510270903,4424,507,4931,0.8971810991685256,4277,353,4630,0.9237580993520519,0.026577000183526267,49361,44085
1400000US24510271001,1842,334,2176,0.8465073529411765,2137,263,2400,0.8904166666666666,0.04390931372549012,36534,35707
1400000US24510271002,3479,654,4133,0.8417614323735785,3881,387,4268,0.9093252108716027,0.0675637784980242,33739,38358
1400000US24510271101,2081,164,2245,0.9269487750556793,1867,119,1986,0.9400805639476334,0.0131317888919541,45909,47188
1400000US24510271102,3919,267,4186,0.9362159579550884,4334,162,4496,0.9639679715302492,0.027752013575160772,160259,209167
1400000US24510271200,5711,244,5955,0.9590260285474391,6289,152,6441,0.976401179941003,0.017375151393563826,114676,135441
1400000US24510271300,2721,67,2788,0.9759684361549498,2627,88,2715,0.9675874769797421,-0.008380959175207647,125185,145966
1400000US24510271400,3478,106,3584,0.9704241071428571,3831,109,3940,0.9723350253807107,0.0019109182378536094,105833,119167
1400000US24510271501,3920,261,4181,0.9375747428844774,4015,62,4077,0.9847927397596272,0.047217996875149826,103333,87422
1400000US24510271503,809,10,819,0.9877899877899878,847,16,863,0.981460023174971,-0.006329964615016781,92083,71848
1400000US24510271600,4126,791,4917,0.8391295505389466,4094,509,4603,0.8894199435150989,0.05029039297615234,30594,28161
1400000US24510271700,4514,580,5094,0.8861405575186494,4389,332,4721,0.9296759161194662,0.04353535860081681,28087,40694
1400000US24510271801,3032,300,3332,0.9099639855942377,2672,283,2955,0.9042301184433165,-0.005733867150921279,26466,26938
1400000US24510271802,2586,635,3221,0.8028562558211736,2202,341,2543,0.8659064097522611,0.06305015393108748,33071,29688
1400000US24510271900,3403,418,3821,0.8906045537817325,3780,168,3948,0.9574468085106383,0.06684225472890581,57458,52200
1400000US24510272003,5351,457,5808,0.9213154269972452,5165,507,5672,0.9106135401974612,-0.01070188679978401,61818,64984
1400000US24510272004,3744,606,4350,0.8606896551724138,3723,88,3811,0.9769089477827342,0.11621929261032038,51897,38125
1400000US24510272005,2968,131,3099,0.9577282994514359,3287,153,3440,0.9555232558139535,-0.002205043637482418,53668,60250
1400000US24510272006,3380,373,3753,0.9006128430588862,3252,251,3503,0.9283471310305452,0.027734287971659,25189,30304
1400000US24510272007,3543,691,4234,0.8367973547472839,4173,448,4621,0.9030512876000866,0.06625393285280268,38750,40455
1400000US24510280101,3172,483,3655,0.8678522571819426,3317,420,3737,0.8876103826598876,0.019758125477944977,44116,45458
1400000US24510280102,4836,913,5749,0.8411897721342843,5517,562,6079,0.9075505839776279,0.06636081184334364,34235,47527
1400000US24510280200,4440,673,5113,0.8683747310776452,4582,399,4981,0.9198956032925115,0.05152087221486634,47451,62857
1400000US24510280301,3434,574,4008,0.8567864271457086,3564,167,3731,0.9552398820691503,0.09845345492344171,32487,40900
1400000US24510280302,1908,321,2229,0.8559892328398385,2395,97,2492,0.9610754414125201,0.10508620857268158,36146,42005
1400000US24510280401,3284,239,3523,0.9321600908316775,3352,252,3604,0.93007769145394,-0.002082399377737465,50565,51309
1400000US24510280402,1593,266,1859,0.85691231845078,1574,78,1652,0.9527845036319612,0.09587218518118124,42826,40781
1400000US24510280403,4767,626,5393,0.8839236046727239,4821,471,5292,0.9109977324263039,0.02707412775357998,52062,60061
1400000US24510280404,1790,251,2041,0.8770210681038707,2164,168,2332,0.9279588336192109,0.05093776551534024,39938,39479
1400000US24510280500,2084,161,2245,0.9282850779510022,1941,308,2249,0.8630502445531347,-0.06523483339786751,9627,15000
1400000US24033806706,2637,460,3097,0.851469163706813,2685,717,3402,0.7892416225749559,-0.062227541131857134,76429,65043
1400000US24033806708,4135,350,4485,0.9219620958751393,3937,329,4266,0.922878574777309,9.164789021696151e-4,49804,69481
1400000US24033806710,4591,1084,5675,0.8089867841409691,4639,647,5286,0.8776012107453651,0.06861442660439598,69167,78987
1400000US24033806711,3436,1176,4612,0.7450130095403296,4340,629,4969,0.8734151740792916,0.12840216453896203,54545,63358
1400000US24033806712,2333,813,3146,0.7415766052129689,3125,211,3336,0.9367505995203836,0.19517399430741478,77125,87830
1400000US24033806713,2748,850,3598,0.763757643135075,3531,591,4122,0.8566229985443959,0.09286535540932095,43762,62524
1400000US24033806714,2156,1074,3230,0.6674922600619195,2796,1228,4024,0.694831013916501,0.02733875385458151,57132,61169
1400000US24033806800,3413,528,3941,0.8660238518142603,3700,500,4200,0.8809523809523809,0.014928529138120594,103750,100129
1400000US24033806900,3603,411,4014,0.8976083707025411,4903,644,5547,0.8839012078601045,-0.01370716284243656,74977,88194
1400000US24033807000,4489,1034,5523,0.8127829078399421,6006,917,6923,0.8675429726996967,0.0547600648597546,42679,37970
1400000US24033807102,2187,391,2578,0.8483320403413499,2208,276,2484,0.8888888888888888,0.04055684854753894,68864,99881
1400000US24033807200,14871,539,15410,0.9650227125243348,13699,214,13913,0.9846187019334436,0.019595989409108783,17887,32045
1400000US24033807301,2926,589,3515,0.8324324324324325,3097,340,3437,0.9010765202211231,0.06864408778869058,61146,60943
1400000US24033807304,1773,452,2225,0.7968539325842696,1815,279,2094,0.8667621776504298,0.06990824506616022,87163,94191
1400000US24033807305,2588,961,3549,0.7292194984502677,3149,390,3539,0.8897993783554676,0.16057987990519995,76287,97500
1400000US24033807404,4020,695,4715,0.8525980911983033,5069,654,5723,0.8857242704875066,0.03312617928920325,80240,84792
1400000US24033807405,4914,677,5591,0.8789125380075121,4789,574,5363,0.8929703524146932,0.014057814407181124,74615,96122
1400000US24033807407,5467,821,6288,0.8694338422391857,5534,451,5985,0.9246449456975773,0.05521110345839153,86815,77417
1400000US24033807408,5162,270,5432,0.9502945508100147,5440,515,5955,0.9135180520570949,-0.03677649875291977,83977,86833
1400000US24033807409,2845,941,3786,0.7514527205493925,3301,922,4223,0.7816717973004973,0.0302190767511048,54917,73125
1400000US24033807410,3050,916,3966,0.7690368129097327,3697,529,4226,0.8748225272124941,0.1057857143027614,57692,64444
1400000US24035810100,2634,327,2961,0.889564336372847,2864,222,3086,0.9280622164614387,0.038497880088591674,51133,59145
1400000US24035810200,1987,518,2505,0.7932135728542914,2504,258,2762,0.9065894279507604,0.11337585509646897,69519,63914
1400000US24035810300,4264,202,4466,0.954769368562472,4227,189,4416,0.9572010869565217,0.0024317183940497644,73226,68432
1400000US24035810400,5725,147,5872,0.9749659400544959,5607,218,5825,0.9625751072961374,-0.012390832758358505,91667,105699
1400000US24035810500,4142,173,4315,0.9599073001158749,5132,253,5385,0.9530176415970287,-0.0068896585188461534,82188,92557
1400000US24035810600,4739,188,4927,0.9618429064339354,4698,259,4957,0.947750655638491,-0.014092250795444405,96250,109327
1400000US24035810700,3635,265,3900,0.9320512820512821,3892,150,4042,0.962889658584859,0.030838376533576906,86261,90707
1400000US24035810800,5293,210,5503,0.9618389969107759,5400,239,5639,0.9576165986877105,-0.00422239822306536,85603,95951
1400000US24035810901,4772,338,5110,0.9338551859099804,4893,85,4978,0.9829248694254721,0.04906968351549168,104730,113500
1400000US24035810902,2959,102,3061,0.9666775563541327,2871,67,2938,0.9771953710006808,0.010517814646548107,92136,91444
1400000US24035811000,3928,811,4739,0.8288668495463178,4027,485,4512,0.8925088652482269,0.06364201570190908,79695,80324
1400000US24035990000,0,0,0,NaN,0,0,0,NaN,NaN,NA,NA
1400000US24035990100,0,0,0,NaN,0,0,0,NaN,NaN,NA,NA
1400000US24035990200,0,0,0,NaN,0,0,0,NaN,NaN,NA,NA
1400000US24037875000,6187,214,6401,0.9665677237931574,6332,122,6454,0.9810969941121785,0.014529270319021181,91927,99547
1400000US24037875100,3971,470,4441,0.894167980184643,4504,880,5384,0.836552748885587,-0.0576152312990561,84198,88438
1400000US24037875201,4759,286,5045,0.9433102081268583,4797,228,5025,0.9546268656716418,0.011316657544783504,86055,96803
1400000US24037875202,5739,434,6173,0.9296938279604731,5624,488,6112,0.9201570680628273,-0.009536759897645797,89163,96619
1400000US24037875300,3097,239,3336,0.9283573141486811,2842,121,2963,0.9591630104623692,0.030805696313688125,74833,56623
1400000US24037875400,6542,501,7043,0.9288655402527332,6233,184,6417,0.9713261648745519,0.042460624621818766,86250,98929
1400000US24037875500,6693,1277,7970,0.8397741530740276,9835,501,10336,0.9515286377708978,0.11175448469687022,92871,102632
1400000US24037875600,7487,679,8166,0.9168503551310311,8157,346,8503,0.9593084793602258,0.042458124229194705,92229,98182
1400000US24037875700,6443,622,7065,0.9119603680113234,7017,282,7299,0.9613645704891081,0.04940420247778465,101342,93949
1400000US24037875801,643,5,648,0.9922839506172839,1066,0,1066,1,0.007716049382716084,55833,59318
1400000US24037875802,3391,304,3695,0.9177266576454668,3959,276,4235,0.9348288075560803,0.01710214991061354,100650,100804
1400000US24037875901,6200,545,6745,0.9191994069681245,6480,271,6751,0.9598577988446156,0.04065839187649112,84458,81500
1400000US24037875902,6908,729,7637,0.904543668979966,7785,833,8618,0.9033418426549084,-0.0012018263250576089,64196,51909
1400000US24037876001,4720,762,5482,0.8609996351696461,4562,395,4957,0.9203147064756909,0.05931507130604485,52134,57665
1400000US24037876002,7539,459,7998,0.9426106526631658,8688,817,9505,0.9140452393477118,-0.028565413315454036,85247,79239
1400000US24037876100,6576,671,7247,0.9074099627432041,7376,325,7701,0.9577976886118685,0.05038772586866447,105595,100685
1400000US24037876200,6546,289,6835,0.957717629846379,6541,220,6761,0.9674604348469161,0.009742805000537147,81916,92130
1400000US24037990000,0,0,0,NaN,0,0,0,NaN,NaN,NA,NA
1400000US24039930101,5913,1235,7148,0.8272243984331281,6362,623,6985,0.9108088761632068,0.08358447773007871,26662,27384
1400000US24039930102,3148,324,3472,0.9066820276497696,3709,260,3969,0.9344923154446964,0.02781028779492678,53083,53591
1400000US24039930200,1421,143,1564,0.9085677749360613,1513,185,1698,0.8910482921083628,-0.01751948282769855,38958,35735
1400000US24039930300,2282,238,2520,0.9055555555555556,1781,296,2077,0.857486759749639,-0.04806879580591661,47336,43250
1400000US24039930500,3345,607,3952,0.8464068825910931,3853,251,4104,0.9388401559454191,0.09243327335432605,54341,53161
1400000US24039930600,2615,292,2907,0.8995528035775714,2648,290,2938,0.9012933968686181,0.0017405932910466992,35865,30465
1400000US24039980400,17,38,55,0.3090909090909091,50,4,54,0.9259259259259259,0.6168350168350168,31944,NA
1400000US24039990100,0,0,0,NaN,0,0,0,NaN,NaN,NA,NA
1400000US24041960100,4024,439,4463,0.9016356710732691,4145,123,4268,0.9711808809746955,0.06954520990142632,67000,84583
1400000US24041960201,3947,138,4085,0.966217870257038,3754,186,3940,0.9527918781725888,-0.013425992084449168,77868,93618
1400000US24041960300,2769,590,3359,0.8243524858588865,3441,324,3765,0.9139442231075697,0.08959173724868319,43056,40759
1400000US24041960400,4181,973,5154,0.8112145906092355,4531,564,5095,0.8893032384690873,0.07808864785985181,49233,41650
1400000US24041960501,4158,563,4721,0.8807456047447575,4536,348,4884,0.9287469287469288,0.048001324002171275,82179,79853
1400000US24041960502,3622,467,4089,0.8857911469797016,3815,123,3938,0.9687658710005078,0.08297472402080619,78151,70368
1400000US24041960600,1656,135,1791,0.9246231155778895,1602,37,1639,0.9774252593044539,0.05280214372656444,77763,78750
1400000US24041960700,3149,301,3450,0.9127536231884058,3165,179,3344,0.9464712918660287,0.033717668677622936,59485,74219
1400000US24041960800,1627,365,1992,0.8167670682730924,1746,193,1939,0.9004641567818463,0.0836970885087539,54760,70402
1400000US24041960900,3769,428,4197,0.8980223969502025,4022,220,4242,0.9481376709099482,0.05011527395974569,63846,77854
1400000US24041990000,0,0,0,NaN,0,0,0,NaN,NaN,NA,NA
1400000US24043000100,2572,501,3073,0.8369671330946957,3157,93,3250,0.9713846153846154,0.13441748228991968,64091,61063
1400000US24043000200,3310,372,3682,0.8989679521998913,3219,188,3407,0.9448194892867625,0.045851537086871175,58220,58417
1400000US24043000301,2681,470,3151,0.8508410028562361,2852,300,3152,0.9048223350253807,0.05398133216914458,40603,41800
1400000US24043000302,2742,467,3209,0.8544717980679339,2496,325,2821,0.8847926267281107,0.030320828660176713,27679,42078
1400000US24043000400,1738,225,1963,0.8853795211411105,1408,187,1595,0.8827586206896552,-0.0026209004514553547,16518,20802
1400000US24043000500,4658,980,5638,0.8261794962752749,5111,539,5650,0.9046017699115044,0.07842227363622956,31554,41439
1400000US24043000601,2135,365,2500,0.854,2061,305,2366,0.871090448013525,0.017090448013524995,38051,42102
1400000US24043000602,2666,245,2911,0.915836482308485,3026,113,3139,0.9640012742911755,0.048164791982690525,41433,45543
1400000US24043000700,2427,593,3020,0.8036423841059602,2509,453,2962,0.8470627954085078,0.04342041130254759,24232,22791
1400000US24043000800,3197,421,3618,0.8836373687119956,3097,191,3288,0.9419099756690997,0.05827260695710412,33721,41962
1400000US24043000900,3133,381,3514,0.8915765509391007,2601,721,3322,0.7829620710415413,-0.10861447989755946,29607,28125
1400000US24043001001,4835,306,5141,0.9404785061272126,4591,399,4990,0.9200400801603207,-0.020438425966891938,38877,44401
1400000US24043001002,3854,299,4153,0.9280038526366482,3777,169,3946,0.9571718195641156,0.02916796692746737,59656,68348
1400000US24043010100,1118,118,1236,0.9045307443365695,925,72,997,0.9277833500501504,0.0232526057135809,51181,57188
1400000US24043010200,3826,832,4658,0.8213825676255904,4045,538,4583,0.88260964433777,0.06122707671217964,74375,76769
1400000US24043010300,6760,881,7641,0.8847009553723335,6797,563,7360,0.9235054347826087,0.038804479410275206,66159,76649
1400000US24043010400,7121,726,7847,0.907480565821333,7745,502,8247,0.9391293803807446,0.0316488145594116,64922,68401
1400000US24043010500,5666,410,6076,0.9325213956550362,5386,871,6257,0.8607959085823877,-0.071725487072648475,57708,52167
1400000US24043010600,4454,632,5086,0.875737318128195,5065,234,5299,0.9558407246650311,0.08010340653683612,68227,60104
1400000US24043010700,3388,299,3687,0.9189042582045023,3099,188,3287,0.9428049893519928,0.023900731147490473,45776,49007
1400000US24043010801,3838,230,4068,0.9434611602753196,4108,222,4330,0.948729792147806,0.0052686318724863845,56406,55139
1400000US24043010802,2160,188,2348,0.919931856899489,2531,170,2701,0.9370603480192521,0.017128491119763112,47015,51681
1400000US24043010900,7808,605,8413,0.9280874836562463,8043,446,8489,0.9474614206620332,0.019373937005786934,74276,74661
1400000US24043011000,0,0,0,NaN,0,0,0,NaN,NaN,NA,NA
1400000US24043011100,5014,731,5745,0.8727589208006963,5810,319,6129,0.9479523576439876,0.07519343684329127,51023,50332
1400000US24043011201,8393,736,9129,0.9193778069887173,8990,380,9370,0.959445037353255,0.04006723036453774,65719,59141
1400000US24043011202,3878,444,4322,0.8972697825080981,4046,453,4499,0.8993109579906646,0.0020411754825665485,61277,62500
1400000US24043011301,4725,333,5058,0.9341637010676157,4709,193,4902,0.9606283149734802,0.02646461390586452,71677,78080
1400000US24043011302,3680,229,3909,0.941417242261448,3851,183,4034,0.9546355974219137,0.013218355160465767,84444,98030
1400000US24043011400,5123,317,5440,0.9417279411764706,5505,126,5631,0.9776238678742675,0.03589592669779684,69207,63527
1400000US24043011500,7263,669,7932,0.9156580937972768,7924,225,8149,0.9723892502147503,0.056731156417473505,70563,88190
1400000US24043011600,2507,283,2790,0.8985663082437276,2884,162,3046,0.9468154957321077,0.04824918748838003,63424,74414
1400000US24045000100,4111,1836,5947,0.691272910711283,5001,903,5904,0.8470528455284553,0.15577993481717223,37908,36819
1400000US24045000200,1820,383,2203,0.8261461643213799,1484,235,1719,0.8632926119837114,0.03714644766233155,35417,53342
1400000US24045000300,1265,391,1656,0.7638888888888888,1246,203,1449,0.8599033816425121,0.09601449275362328,25071,25704
1400000US24045000400,4286,574,4860,0.8818930041152263,3642,475,4117,0.8846247267427738,0.002731722627547506,37292,45742
1400000US24045000500,2018,163,2181,0.9252636405318662,2975,275,3250,0.9153846153846154,-0.009879025147250808,37431,33924
1400000US24045010101,5031,794,5825,0.8636909871244636,5792,281,6073,0.9537296229211263,0.09003863579666271,55769,46863
1400000US24045010102,2335,273,2608,0.8953220858895705,3434,266,3700,0.9281081081081081,0.03278602221853755,46381,53064
1400000US24045010200,5429,1214,6643,0.8172512419087762,4540,520,5060,0.8972332015810277,0.07998195967225152,31538,36932
1400000US24045010300,7858,419,8277,0.9493777938866739,7993,460,8453,0.9455814503726487,-0.0037963435140251356,87926,98590
1400000US24045010400,5821,517,6338,0.918428526349006,6300,475,6775,0.9298892988929889,0.011460772543982922,54537,52054
1400000US24045010501,4016,713,4729,0.8492281666314231,5124,520,5644,0.9078667611622963,0.05863859453087317,55805,68652
1400000US24045010502,6893,1042,7935,0.8686830497794581,8861,446,9307,0.9520790802621683,0.08339603048271016,39528,38805
1400000US24045010603,6489,922,7411,0.8755903386857374,6843,542,7385,0.9266079891672309,0.051017650481493426,56471,55045
1400000US24045010604,4389,703,5092,0.8619402985074627,4222,443,4665,0.905037513397642,0.04309721489017937,50373,52523
1400000US24045010605,3896,359,4255,0.9156286721504113,3924,227,4151,0.945314382076608,0.02968570992619668,89886,84671
1400000US24045010606,3455,277,3732,0.9257770632368703,4045,409,4454,0.9081724292770543,-0.01760463395981593,64497,63906
1400000US24045010701,3771,337,4108,0.917964946445959,3924,279,4203,0.9336188436830836,0.015653897237124514,60192,59375
1400000US24045010702,7110,1031,8141,0.8733570814396265,6705,1031,7736,0.8667269906928645,-0.0066300907467620185,52209,59262
1400000US24045010800,5171,630,5801,0.8913980348215825,6276,404,6680,0.9395209580838323,0.04812292326224976,60100,72755
1400000US24047950000,1510,94,1604,0.9413965087281796,1480,179,1659,0.8921036769138035,-0.04929283181437605,52991,51042
1400000US24047950100,2086,173,2259,0.9234174413457282,2157,108,2265,0.952317880794702,0.028900439448973803,67188,81500
1400000US24047950300,2917,338,3255,0.8961597542242703,2961,205,3166,0.9352495262160455,0.03908977199177521,47545,52005
1400000US24047950400,2847,224,3071,0.9270595897101921,2785,119,2904,0.9590220385674931,0.03196244885730104,78373,71889
1400000US24047950600,2623,225,2848,0.920997191011236,2729,220,2949,0.9253984401492031,0.004401249137967134,67083,74571
1400000US24047950700,1695,318,2013,0.842026825633383,2516,82,2598,0.968437259430331,0.12641043379694794,76927,73912
1400000US24047950800,5580,220,5800,0.9620689655172414,4651,394,5045,0.9219028741328048,-0.04016609138443661,66737,68347
1400000US24047950900,1587,293,1880,0.8441489361702128,1656,132,1788,0.9261744966442953,0.08202556047408249,36968,70625
1400000US24047951000,3137,996,4133,0.7590128236148076,4173,249,4422,0.9436906377204884,0.18467781410568085,53234,43917
1400000US24047951100,5499,379,5878,0.9355222864920041,6323,399,6722,0.940642665873252,0.005120379381247875,76212,65946
1400000US24047951200,3234,442,3676,0.8797606093579978,3128,266,3394,0.9216263995285798,0.04186579017058201,56192,74844
1400000US24047951300,2437,191,2628,0.9273211567732116,2172,252,2424,0.8960396039603961,-0.03128155281281553,40327,36832
1400000US24047951400,3061,382,3443,0.8890502468777229,3337,274,3611,0.9241207421766824,0.03507049529895945,61107,55742
1400000US24047951500,4403,691,5094,0.8643502159403219,4152,411,4563,0.9099276791584484,0.0455774632181265,34078,35943
1400000US24047951700,2736,372,3108,0.8803088803088803,2912,462,3374,0.8630705394190872,-0.017238340889793147,55000,58425
1400000US24047980000,0,0,0,NaN,0,0,0,NaN,NaN,NA,NA
1400000US24047990000,0,0,0,NaN,0,0,0,NaN,NaN,NA,NA
1400000US24510010100,2583,218,2801,0.9221706533380936,2951,79,3030,0.973927392739274,0.05175673940118042,84677,95625
1400000US24510010200,2719,814,3533,0.7696009057458251,3051,94,3145,0.9701112877583465,0.20051038201252147,68264,109102
1400000US24510010300,2045,181,2226,0.9186882300089847,2439,98,2537,0.9613716988569176,0.04268346884793295,86979,137275
1400000US24510010400,1927,103,2030,0.9492610837438423,2411,155,2566,0.9395946999220577,-0.009666383821784641,76528,112059
1400000US24510010500,1818,170,1988,0.9144869215291751,1548,142,1690,0.9159763313609467,0.0014894098317715931,96875,92000
1400000US24510020100,1692,572,2264,0.7473498233215548,1680,194,1874,0.8964781216648879,0.1491282983433332,76143,88553
1400000US24510020200,1512,490,2002,0.7552447552447552,1701,153,1854,0.9174757281553398,0.16223097291058464,60897,80221
1400000US24510020300,3340,174,3514,0.9504837791690381,3707,61,3768,0.9838110403397028,0.033327261170664646,68876,96667
1400000US24510030100,2015,410,2425,0.8309278350515464,2917,438,3355,0.8694485842026826,0.038520749151136124,16899,28227
1400000US24510030200,2119,217,2336,0.9071061643835616,2137,174,2311,0.9247079186499351,0.01760175426637345,64107,88077
1400000US24510040100,3181,100,3281,0.9695214873514173,3896,111,4007,0.9722984776640878,0.0027769903126705353,49534,61754
1400000US24510040200,921,127,1048,0.8788167938931297,821,44,865,0.9491329479768786,0.07031615408374892,9801,56250
1400000US24510060100,2168,934,3102,0.6989039329464861,2702,246,2948,0.9165535956580733,0.21764966271158714,57303,55781
1400000US24510060200,2396,771,3167,0.7565519419008525,2608,462,3070,0.8495114006514658,0.09295945875061329,49403,66371
1400000US24510060300,1594,152,1746,0.9129438717067583,1693,234,1927,0.8785677218474313,-0.03437614985932702,58240,57679
1400000US24510060400,1212,288,1500,0.808,1362,71,1433,0.9504535938590369,0.1424535938590369,31731,51932
1400000US24510070100,2940,326,3266,0.9001837109614207,2636,253,2889,0.9124264451367256,0.012242734175304859,41766,33750
1400000US24510070200,3086,776,3862,0.7990678404971517,2382,435,2817,0.845580404685836,0.04651256418868421,24837,28510
1400000US24510070300,1075,62,1137,0.9454705364995603,709,176,885,0.8011299435028248,-0.1443405929967354,20250,28566
1400000US24510070400,1077,146,1223,0.8806214227309894,1301,194,1495,0.8702341137123746,-0.010387309018614843,15658,19034
1400000US24510080101,2862,509,3371,0.8490062296054584,3791,202,3993,0.949411470072627,0.1004052404671687,53542,60511
1400000US24510080102,1995,454,2449,0.814618211514904,2020,161,2181,0.9261806510774874,0.11156243956258338,38995,34167
1400000US24510080200,1159,101,1260,0.9198412698412698,1507,32,1539,0.9792072774528915,0.059366007611621696,21964,28958
1400000US24510080301,1542,158,1700,0.9070588235294118,1463,190,1653,0.8850574712643678,-0.02200135226504396,33929,38553
1400000US24510080302,2637,305,2942,0.8963290278721958,2738,264,3002,0.9120586275816123,0.015729599709416453,22218,33429
1400000US24510080400,1067,256,1323,0.8065003779289494,1072,139,1211,0.8852188274153592,0.07871844948640982,23299,23472
1400000US24510080500,1291,301,1592,0.8109296482412061,1549,134,1683,0.9203802733214498,0.10945062508024372,33914,29583
1400000US24510080600,1935,342,2277,0.849802371541502,2289,129,2418,0.9466501240694789,0.09684775252797695,27305,34881
1400000US24510080700,679,190,869,0.7813578826237054,661,36,697,0.9483500717360115,0.16699218911230607,15500,30278
1400000US24510080800,821,169,990,0.8292929292929293,1350,102,1452,0.9297520661157025,0.10045913682277319,29667,33750
1400000US24510090100,3985,707,4692,0.8493179880647911,3851,193,4044,0.9522749752720079,0.1029569872072168,31829,44904
1400000US24510090200,3108,374,3482,0.8925904652498564,2849,100,2949,0.9660902000678196,0.07349973481796324,71515,66552
1400000US24510090300,3511,627,4138,0.8484775253745771,4243,315,4558,0.9308907415533129,0.08241321617873576,36094,40231
1400000US24510090400,1215,182,1397,0.8697208303507517,1457,299,1756,0.8297266514806378,-0.039994178870113806,28008,31696
1400000US24510090500,1708,486,2194,0.7784867821330902,1845,112,1957,0.942769545222279,0.16428276308918877,34167,42347
1400000US24510090600,2652,588,3240,0.8185185185185185,2932,323,3255,0.900768049155146,0.08224953063662743,36109,46037
1400000US24510090700,3146,502,3648,0.862390350877193,2855,235,3090,0.9239482200647249,0.06155786918753192,29050,30242
1400000US24510090800,3102,588,3690,0.8406504065040651,2507,290,2797,0.8963174830175188,0.055667076513453706,27113,34185
1400000US24510090900,2087,345,2432,0.858141447368421,2273,227,2500,0.9092,0.05105855263157899,14247,23816
1400000US24510100100,1875,368,2243,0.8359340169415961,2078,150,2228,0.9326750448833034,0.09674102794170736,24665,24146
1400000US24510100200,2771,250,3021,0.9172459450513075,2328,55,2383,0.9769198489299202,0.05967390387861271,10013,14452
1400000US24510100300,0,0,0,NaN,0,0,0,NaN,NaN,NA,NA
1400000US24031700903,1679,232,1911,0.8785975928833072,2008,275,2283,0.879544459045116,9.468661618088348e-4,78417,74444
1400000US24031700904,2348,506,2854,0.8227049754730204,2562,459,3021,0.8480635551142006,0.025358579641180268,72784,48646
1400000US24031700905,3772,187,3959,0.9527658499621117,4092,67,4159,0.9838903582591969,0.03112450829708524,83008,73158
1400000US24031701001,4799,476,5275,0.9097630331753555,5494,358,5852,0.9388243335611757,0.02906130038582022,98583,89892
1400000US24031701002,3658,35,3693,0.9905226103438939,3469,60,3529,0.9829980164352508,-0.007524593908643129,205170,196250
1400000US24031701004,4654,341,4995,0.9317317317317317,5293,291,5584,0.9478868194842407,0.016155087752508956,101895,112582
1400000US24031701005,3105,176,3281,0.9463578177384944,3436,141,3577,0.960581492871121,0.014223675132626679,119038,148705
1400000US24031701006,4972,235,5207,0.9548684463222585,5088,102,5190,0.9803468208092485,0.025478374486989974,124107,149539
1400000US24031701007,3030,176,3206,0.9451029320024953,3072,125,3197,0.960900844541758,0.01579791253926266,106550,107375
1400000US24031701101,3757,646,4403,0.8532818532818532,3908,946,4854,0.8051091882983107,-0.04817266498354256,97000,130658
1400000US24031701102,5383,961,6344,0.8485182849936949,4704,1817,6521,0.7213617543321577,-0.1271565306615372,85682,84652
1400000US24031701201,4687,661,5348,0.8764023934181002,5185,779,5964,0.869382964453387,-0.0070194289647131924,81125,68601
1400000US24031701202,2593,85,2678,0.9682598954443614,2775,22,2797,0.9921344297461566,0.023874534301795203,139696,160833
1400000US24031701205,5964,352,6316,0.9442685243825206,6518,213,6731,0.9683553706730055,0.024086846290484853,168472,155950
1400000US24031701206,6163,341,6504,0.9475707257072571,6230,187,6417,0.9708586566931589,0.02328793098590176,137790,170000
1400000US24031701210,3846,174,4020,0.9567164179104478,3828,121,3949,0.9693593314763231,0.012642913565875324,173000,207143
1400000US24031701211,5625,504,6129,0.9177679882525698,6081,363,6444,0.9436685288640596,0.02590054061148983,120811,84886
1400000US24031701212,2569,79,2648,0.970166163141994,2830,89,2919,0.9695101062007537,-6.560569412402684e-4,143125,150208
1400000US24031701213,5781,144,5925,0.9756962025316456,6750,310,7060,0.9560906515580736,-0.019605550973571972,117813,114035
1400000US24031701214,2364,222,2586,0.91415313225058,3575,150,3725,0.959731543624161,0.045578411373580985,83533,108125
1400000US24031701215,4151,95,4246,0.9776260009420631,4710,84,4794,0.9824780976220275,0.004852096679964446,79153,94559
1400000US24031701216,3621,334,3955,0.9155499367888749,4454,237,4691,0.9494777232999361,0.03392778651106121,91652,98155
1400000US24031701218,2194,155,2349,0.9340144742443593,2553,103,2656,0.9612198795180723,0.027205405273712957,70833,77188
1400000US24031701219,2378,582,2960,0.8033783783783783,3742,543,4285,0.8732788798133022,0.06990050143492388,66289,56006
1400000US24031701220,4091,177,4268,0.9585285848172446,3814,79,3893,0.9797071667094785,0.021178581892233983,195568,193226
1400000US24031701221,4176,168,4344,0.9613259668508287,4245,166,4411,0.9623668102471095,0.001040843396280744,123643,129313
1400000US24031701303,3624,169,3793,0.955444239388347,3380,11,3391,0.9967561191388971,0.04131187975055006,127202,154345
1400000US24031701304,5751,335,6086,0.9449556358856391,5852,143,5995,0.9761467889908257,0.03119115310518661,123359,122569
1400000US24031701306,2863,173,3036,0.9430171277997365,2958,87,3045,0.9714285714285714,0.028411443628834965,144714,150588
1400000US24031701307,3503,227,3730,0.939142091152815,4193,129,4322,0.9701527070800555,0.031010615927240526,140833,159091
1400000US24031701308,2709,212,2921,0.9274221157137966,3155,51,3206,0.9840923268870867,0.056670211173290075,144038,175357
1400000US24031701312,5789,295,6084,0.9515121630506246,6457,58,6515,0.9910974673829624,0.03958530433233787,133824,144811
1400000US24031701313,3341,302,3643,0.9171012901454845,3634,94,3728,0.9747854077253219,0.05768411757983738,112635,133589
1400000US24031701314,2802,181,2983,0.9393228293664097,3171,83,3254,0.9744929317762754,0.03517010240986573,102533,110156
1400000US24031701315,4169,490,4659,0.8948272161408027,4550,84,4634,0.9818731117824774,0.08704589564167464,105930,109256
1400000US24031701316,5414,273,5687,0.9519957798487779,6148,238,6386,0.9627309740056373,0.010735194156859418,113818,135648
1400000US24031701317,4164,91,4255,0.9786133960047003,4233,263,4496,0.9415035587188612,-0.037109837285839165,161171,167629
1400000US24031701407,5115,425,5540,0.9232851985559567,5524,197,5721,0.965565460583814,0.042280262027857285,122981,141389
1400000US24031701408,5876,540,6416,0.9158354114713217,6339,326,6665,0.9510877719429858,0.035252360471664024,140492,120644
1400000US24031701409,4022,178,4200,0.9576190476190476,4243,363,4606,0.9211897524967434,-0.036429295122304195,144324,125694
1400000US24031701410,6330,595,6925,0.9140794223826715,8226,1026,9252,0.8891050583657587,-0.024974364016912776,85583,96262
1400000US24031701414,6229,852,7081,0.8796780115802852,5985,1431,7416,0.8070388349514563,-0.0726391766288289,84538,103105
1400000US24031701415,6413,1137,7550,0.8494039735099338,7017,766,7783,0.9015803674675575,0.052176393957623746,97955,102841
1400000US24031701417,5231,639,5870,0.8911413969335604,5313,503,5816,0.9135144429160935,0.02237304598253309,60280,81809
1400000US24031701418,3003,470,3473,0.8646703138496976,3216,265,3481,0.9238724504452743,0.059202136595576715,108503,110714
1400000US24031701420,5882,733,6615,0.8891912320483749,6565,124,6689,0.9814621019584392,0.09227086991006428,66187,74621
1400000US24031701421,1435,472,1907,0.7524908232826429,1640,422,2062,0.7953443258971872,0.04285350261454424,73110,79450
1400000US24031701422,2142,697,2839,0.7544910179640718,2612,670,3282,0.7958561852528946,0.04136516728882278,43257,53308
1400000US24031701423,3803,931,4734,0.8033375580904099,4229,462,4691,0.90151353655936906,0.0981759784689592,63681,67478
1400000US24031701503,6149,789,6938,0.8862784664168348,6368,446,6814,0.9345465218667449,0.048268055449910086,94261,115208
1400000US24031701505,5478,1463,6941,0.7892234548335975,6369,899,7268,0.8763070996147496,0.08708364478115216,75918,85799
1400000US24031701506,4549,436,4985,0.9125376128385155,4915,291,5206,0.9441029581252401,0.03156534528672461,129153,126705
1400000US24031701507,4678,320,4998,0.9359743897559024,4624,366,4990,0.9266533066132264,-0.00932108314267599,128750,123164
1400000US24031701508,3107,683,3790,0.8197889182058048,3594,473,4067,0.8836980575362675,0.06390913933046272,52764,57885
1400000US24031701509,4109,1337,5446,0.7544987146529563,5632,1113,6745,0.834988880652335,0.08049016599937875,48199,54417
1400000US24031701601,1607,551,2158,0.7446709916589435,1865,757,2622,0.7112890922959573,-0.03338189936298619,54041,60938
1400000US24031701602,4065,2767,6832,0.5949941451990632,5561,1738,7299,0.7618851897520208,0.16689104455295756,61005,71563
1400000US24031701701,2849,232,3081,0.9246997728010387,3179,234,3413,0.9314386170524466,0.006738844251407916,71958,113698
1400000US24031701702,1936,547,2483,0.779701973419251,2079,568,2647,0.7854174537211938,0.005715480301942799,57917,50000
1400000US24031701703,2942,766,3708,0.7934196332254585,3262,332,3594,0.907623817473567,0.11420418424810852,82986,96985
1400000US24031701704,2530,287,2817,0.8981185658501952,2962,61,3023,0.9798213695004961,0.08170280365030091,85071,121089
1400000US24031701800,3944,696,4640,0.85,4545,466,5011,0.9070045899022151,0.05700458990221513,64419,81114
1400000US24031701900,1864,1337,3201,0.5823180256169946,2541,706,3247,0.7825685247921158,0.20025049917512117,55933,67860
1400000US24031702000,3333,2109,5442,0.6124586549062845,4060,1678,5738,0.7075636110142907,0.09510495610800618,48162,54250
1400000US24031702101,3889,1705,5594,0.6952091526635681,4817,1304,6121,0.7869629145564451,0.09175376189287698,53372,54508
1400000US24031702102,2746,106,2852,0.9628330995792427,3254,85,3339,0.9745432764300689,0.011710176850826204,135417,160074
1400000US24031702200,3919,197,4116,0.9521379980563655,4696,344,5040,0.9317460317460318,-0.020391966310333687,128707,134458
1400000US24031702301,2886,1442,4328,0.6668207024029574,2585,1113,3698,0.6990265008112493,0.03220579840829185,64315,53182
1400000US24031702302,3554,792,4346,0.8177634606534745,3662,349,4011,0.912989279481426,0.09522581882795156,73367,81473
1400000US24031702401,2230,254,2484,0.8977455716586151,2507,39,2546,0.9846818538884525,0.0869362822298374,128882,144583
1400000US24031702402,4026,255,4281,0.9404344779257183,4207,99,4306,0.9770088248954947,0.03657434696977635,67908,68575
1400000US24031702500,4391,854,5245,0.8371782650142994,6738,347,7085,0.9510232886379676,0.11384502362366822,61611,66868
1400000US24031702601,4046,335,4381,0.9235334398539147,4302,247,4549,0.9457023521653111,0.022168912311396394,70341,71161
1400000US24031702602,3881,756,4637,0.836963554021997,4387,772,5159,0.8503585966272533,0.013395042605256369,61723,64375
1400000US24031702700,5146,1322,6468,0.7956091527520099,6704,631,7335,0.9139740967961827,0.11836494404417275,98864,94524
1400000US24031702800,4370,209,4579,0.9543568464730291,4919,209,5128,0.9592433697347894,0.004886523261760312,91694,96372
1400000US24031702900,5336,181,5517,0.9671923146637665,5112,114,5226,0.9781859931113662,0.010993678447599686,116875,109867
1400000US24031703000,1648,137,1785,0.923249299719888,1831,56,1887,0.9703232644409115,0.04707396472102354,99688,133542
1400000US24031703100,3544,715,4259,0.8321202160131487,3937,587,4524,0.8702475685234305,0.038127352510281876,100000,111198
1400000US24031703201,6487,1110,7597,0.8538896932999869,6928,978,7906,0.8762964836832785,0.02240679038329163,97768,111264
1400000US24031703202,5428,592,6020,0.9016611295681063,5733,208,5941,0.9649890590809628,0.06332792951285648,115133,121835
1400000US24031703206,3283,568,3851,0.8525058426382758,3508,214,3722,0.9425040300913488,0.08999818745307298,92188,93321
1400000US24031703207,4175,1739,5914,0.7059519783564423,4869,1440,6309,0.7717546362339515,0.06580265787750916,59265,58340
1400000US24031703208,4846,257,5103,0.9496374681559867,4938,463,5401,0.914275134234401,-0.03536233392158572,119708,121477
1400000US24031703209,4654,971,5625,0.8273777777777778,5536,906,6442,0.8593604470661286,0.03198266928835081,55188,92176
1400000US24031703210,3043,441,3484,0.8734213547646383,3015,394,3409,0.8844235846289235,0.011002229864285118,109135,91597
1400000US24031703212,6667,1141,7808,0.8538678278688525,8526,1173,9699,0.8790596968759666,0.02519186900711412,107031,104286
1400000US24031703213,4440,1264,5704,0.7784011220196353,5018,1391,6409,0.7829614604462475,0.004560338426612187,49587,42955
1400000US24031703214,5214,1558,6772,0.7699350265800354,6075,1757,7832,0.7756639427987743,0.005728916218738833,43942,65353
1400000US24031703215,2579,718,3297,0.7822262663026994,2843,425,3268,0.8699510403916769,0.0877247740889775,91587,79881
1400000US24031703216,3319,219,3538,0.9381006218202375,3503,330,3833,0.9139055570049569,-0.024195064815280554,56510,54041
1400000US24031703218,1737,0,1737,1,1868,0,1868,1,0,50757,55354
1400000US24031703219,3383,51,3434,0.9851485148514851,3361,32,3393,0.9905688181550251,0.005420303303539931,55512,53297
1400000US24031703220,4052,495,4547,0.8911370134154387,4596,586,5182,0.8869162485526824,-0.004220764862756354,64306,61599
1400000US24031703221,4060,587,4647,0.8736819453410802,4682,749,5431,0.8620880132572271,-0.011593932083853176,104571,103113
1400000US24031703301,2972,1361,4333,0.685898915301177,4472,791,5263,0.8497054911647349,0.16380657586355796,71364,94583
1400000US24031703302,3040,1377,4417,0.688249943400498,3425,1087,4512,0.7590868794326241,0.07083693603212604,78614,81544
1400000US24031703401,3783,1520,5303,0.7133697906845182,4320,1138,5458,0.79149871747893,0.07812892679441175,75435,81944
1400000US24031703402,2827,575,3402,0.8309817754262199,3419,166,3585,0.9536959553695955,0.12271417994337563,100995,81667
1400000US24031703403,2462,1117,3579,0.687901648505169,3089,491,3580,0.8628491620111732,0.17494751350600424,72989,80188
1400000US24031703404,2141,838,2979,0.7186975495132595,2256,1047,3303,0.6830154405086285,-0.03568210900463098,48578,70227
1400000US24031703501,4502,2222,6724,0.6695419393218323,5266,1172,6438,0.8179558869214042,0.14841394759957194,56638,63093
1400000US24031703502,2603,746,3349,0.777246939384891,2595,188,2783,0.9324469996406756,0.1552000602557846,71406,82964
1400000US24031703601,3839,771,4610,0.8327548806941432,4361,417,4778,0.9127249895353704,0.07997010884122724,81389,99907
1400000US24031703602,2658,208,2866,0.9274249825540823,2811,301,3112,0.9032776349614395,-0.02414734759264281,117500,131384
1400000US24031703701,2834,1108,3942,0.7189244038559107,3483,939,4422,0.7876526458616011,0.06872824200569039,66064,73375
1400000US24031703702,2854,1022,3876,0.7363261093911249,3429,962,4391,0.780915508995673,0.04458939960454811,79750,100045
1400000US24031703800,2302,573,2875,0.800695652173913,3030,478,3508,0.863740022805017,0.06304437063110402,56789,67321
1400000US24031703901,2823,172,2995,0.9425709515859766,3056,293,3349,0.91251119737235,-0.03005975421362661,108875,127411
1400000US24031703902,5505,1727,7232,0.761200221238938,6161,1110,7271,0.847338742951451,0.0861385217125129,75345,92147
1400000US24031704000,5740,886,6626,0.8662843344400846,5887,552,6439,0.9142724025469794,0.04798806810689482,75980,82829
1400000US24031704100,4231,81,4312,0.9812152133580705,4549,63,4612,0.9863399826539462,0.005124769295875686,157973,177443
1400000US24031704200,1799,107,1906,0.9438614900314796,2083,62,2145,0.9710955710955711,0.02723408106409153,100694,127000
1400000US24031704300,3520,81,3601,0.977506248264371,3943,51,3994,0.9872308462694042,0.009724598005033114,136597,176250
1400000US24031704401,2859,197,3056,0.9355366492146597,3376,97,3473,0.9720702562625971,0.0365336070479374,144700,184459
1400000US24031704403,1364,94,1458,0.9355281207133059,1566,50,1616,0.969059405940594,0.0335312852272881,86071,86920
1400000US24031704404,4939,150,5089,0.9705246610336019,4974,144,5118,0.9718640093786636,0.001339348345061664,134732,135462
1400000US24031704501,3152,152,3304,0.9539951573849879,3454,70,3524,0.9801362088535754,0.026141051468587584,120417,139643
1400000US24031704502,2585,49,2634,0.9813971146545178,2518,7,2525,0.9972277227722772,0.01583060811775938,184500,201429
1400000US24031704503,3690,151,3841,0.9606873210101536,3966,144,4110,0.964963503649635,0.004276182639481374,160069,208220
1400000US24031704600,5046,146,5192,0.9718798151001541,4840,47,4887,0.9903826478412113,0.01850283274105724,146116,206500
1400000US24031704700,3728,130,3858,0.9663037843442198,3723,25,3748,0.9933297758804696,0.027025991536249738,247064,NA
1400000US24031704803,2995,301,3296,0.9086771844660194,3591,194,3785,0.9487450462351387,0.04006786176911925,73884,71774
1400000US24031704804,1281,52,1333,0.9609902475618904,1632,30,1662,0.9819494584837545,0.020959210921864035,113382,106953
1400000US24031704805,1368,174,1542,0.8871595330739299,1972,24,1996,0.9879759519038076,0.10081641882987769,116653,96875
1400000US24031704806,2923,55,2978,0.9815312290127602,3134,89,3223,0.972385975798945,-0.009145253213815208,84004,94623
1400000US24031705000,3827,92,3919,0.9765246236284767,4126,48,4174,0.9885002395783421,0.011975615949865404,117336,148060
1400000US24031705100,4942,81,5023,0.983874178777623,4838,180,5018,0.9641291351135911,-0.019745043664031847,173092,201534
1400000US24031705200,3332,13,3345,0.9961136023916293,3271,26,3297,0.992114043069457,-0.003999559322172219,240568,NA
1400000US24031705300,1911,22,1933,0.9886187273667874,1902,17,1919,0.9911412193850964,0.0025224920183090083,NA,NA
1400000US24031705400,2809,32,2841,0.9887363604364661,2943,7,2950,0.9976271186440678,0.008890758207601768,NA,NA
1400000US24031705501,2349,58,2407,0.9759036144578314,2485,110,2595,0.9576107899807321,-0.018292824477099234,106364,108011
1400000US24031705502,3843,98,3941,0.9751332149200711,3889,27,3916,0.9931052093973443,0.017971994477273157,160500,214286
1400000US24031705601,2746,32,2778,0.9884809215262779,2904,25,2929,0.9914646637077501,0.0029837421814722376,201066,235938
1400000US24031705602,4123,172,4295,0.959953434225844,4371,506,4877,0.8962476932540496,-0.06370574097179438,81788,96250
1400000US24031705701,4171,24,4195,0.9942789034564958,4448,91,4539,0.9799515311742675,-0.014327372282228357,149205,167683
1400000US24031705702,4351,65,4416,0.9852807971014492,4559,0,4559,1,0.014719202898550776,173646,195125
1400000US24031705800,5992,381,6373,0.9402165385218892,5955,86,6041,0.9857639463664956,0.045547407844606314,167000,193421
1400000US24031705901,3770,41,3811,0.9892416688533193,4093,43,4136,0.9896034816247582,3.6181277143887414e-4,196917,227708
1400000US24031705902,4119,164,4283,0.9617090824188653,4061,73,4134,0.9823415578132559,0.020632475394390615,186125,218417
1400000US24031705903,4482,65,4547,0.9857048603474818,4321,56,4377,0.987205848754855,0.0015009884073731161,199250,228816
1400000US24031706005,4336,346,4682,0.9260999572832123,4369,70,4439,0.9842306825861681,0.05813072530295582,210096,227778
1400000US24031706007,6570,492,7062,0.9303313508920985,7186,191,7377,0.9741087162803308,0.04377736538823229,197731,237298
1400000US24031706008,5125,58,5183,0.9888095697472506,5474,59,5533,0.989336707030544,5.271372832933441e-4,NA,218431
1400000US24031706009,5491,209,5700,0.9633333333333334,5201,156,5357,0.9708792234459586,0.0075458901126251865,239327,NA
1400000US24031706010,2601,66,2667,0.9752530933633295,2932,165,3097,0.9467226348078785,-0.028530458555451,133646,136688
1400000US24031706011,5053,111,5164,0.9785050348567003,5235,84,5319,0.9842075578116187,0.005702522954918465,194236,204844
1400000US24031706012,2978,153,3131,0.9511338230597254,3178,166,3344,0.9503588516746412,-7.749713850841999e-4,66029,66778
1400000US24031706013,2751,102,2853,0.964248159831756,2884,72,2956,0.9756427604871448,0.011394600655388776,194886,216500
1400000US24033800102,2614,538,3152,0.8293147208121827,2478,155,2633,0.9411317888340296,0.11181706802184688,57593,56806
1400000US24033800103,1671,539,2210,0.7561085972850679,1990,286,2276,0.8743409490333919,0.11823235174832403,53906,54056
1400000US24033800105,3160,615,3775,0.8370860927152318,3402,474,3876,0.8777089783281734,0.040622885612941584,80595,84022
1400000US24033800106,2174,284,2458,0.8844589096826688,2584,264,2848,0.9073033707865169,0.02284446110384808,86333,90855
1400000US24033800108,2507,513,3020,0.8301324503311258,2973,441,3414,0.8708260105448155,0.04069356021368964,69167,63195
1400000US24033800109,3333,713,4046,0.82377656945131,3035,562,3597,0.8437586877953851,0.01998211834407515,55954,63229
1400000US24033800203,3920,603,4523,0.866681406146363,4266,177,4443,0.9601620526671168,0.09348064652075383,126750,118920
1400000US24033800206,3543,541,4084,0.8675318315377081,3810,285,4095,0.9304029304029304,0.06287109886522235,83793,77500
1400000US24033800208,6933,646,7579,0.9147644808022166,7305,747,8052,0.9072280178837556,-0.0075364629184609955,93456,96628
1400000US24033800209,2737,702,3439,0.7958708927013667,3192,945,4137,0.7715736040609137,-0.024297288640452996,51433,51176
1400000US24033800210,2466,709,3175,0.7766929133858268,2350,284,2634,0.8921791951404707,0.11548628175464393,64375,59681
1400000US24033800211,2194,463,2657,0.8257433195333083,2867,337,3204,0.8948189762796505,0.0690756567463422,50851,49719
1400000US24033800212,3441,462,3903,0.8816295157571099,4259,234,4493,0.9479189850879145,0.0662894693308046,100017,88194
1400000US24033800213,3417,472,3889,0.8786320390845976,4334,546,4880,0.8881147540983606,0.009482715013762966,79142,83281
1400000US24033800214,1925,390,2315,0.8315334773218143,2112,328,2440,0.8655737704918033,0.03404029316998902,58781,62796
1400000US24033800215,2164,395,2559,0.845642829230168,2506,82,2588,0.9683153013910355,0.12267247216086752,72792,74613
1400000US24033800401,2652,334,2986,0.8881446751507033,2205,165,2370,0.930379746835443,0.04223507168473972,119038,110625
1400000US24033800402,4516,281,4797,0.9414217219095268,4482,202,4684,0.9568744662681469,0.015452744358620096,100643,105000
1400000US24033800403,3807,234,4041,0.9420935412026726,3622,164,3786,0.9566825145272055,0.014588973324532906,121098,109545
1400000US24033800408,6253,504,6757,0.9254106852153322,6501,636,7137,0.9108869272803699,-0.0145237579349623,109022,141750
1400000US24033800409,5521,693,6214,0.8884776311554554,5777,333,6110,0.9454991816693944,0.05702155051393898,114427,137339
1400000US24033800410,6009,599,6608,0.9093523002421308,6685,304,6989,0.9565030762626985,0.04715077602056772,128038,126922
1400000US24033800411,3665,396,4061,0.9024870721497168,3627,222,3849,0.9423226812159002,0.03983560906618344,87281,110139
1400000US24033800412,2514,694,3208,0.7836658354114713,3295,310,3605,0.9140083217753121,0.13034248636384083,59703,75933
1400000US24033800413,3210,354,3564,0.9006734006734006,3476,681,4157,0.8361799374548954,-0.06449346321850524,83277,72901
1400000US24033800504,4500,292,4792,0.9390651085141903,4443,370,4813,0.9231248701433618,-0.015940238370828586,114769,115139
