GEO_ID,NAME,total,total.under25K,total.under25K.insured,total.under25K.insured.private,total.under25K.insured.public,total.under25K.uninsured,total.25Kto50K,total.25Kto50K.insured,total.25Kto50K.insured.private,total.25Kto50K.insured.public,total.25Kto50K.uninsured,total.50Kto75K,total.50Kto75K.insured,total.50Kto75K.insured.private,total.50Kto75K.insured.public,total.50Kto75K.uninsured,total.75Kto100K,total.75Kto100K.insured,total.75Kto100K.insured.private,total.75Kto100K.insured.public,total.75Kto100K.uninsured,total.100Kplus,total.100Kplus.insured,total.100Kplus.insured.private,total.100Kplus.insured.public,total.100Kplus.uninsured
1400000US24001000100,"Census Tract 1, Allegany County, Maryland",3488,586,468,176,446,118,815,667,463,406,148,1110,1053,899,311,57,280,273,252,66,7,697,686,672,98,11
1400000US24001000200,"Census Tract 2, Allegany County, Maryland",2804,445,428,169,313,17,843,771,507,554,72,655,655,620,119,0,352,339,335,70,13,509,509,474,68,0
1400000US24001000300,"Census Tract 3, Allegany County, Maryland",2455,455,403,106,396,52,769,738,603,409,31,424,386,290,113,38,391,391,360,65,0,416,369,369,93,47
1400000US24001000400,"Census Tract 4, Allegany County, Maryland",2747,496,496,196,415,0,644,595,392,455,49,485,446,419,127,39,304,276,262,49,28,818,786,688,120,32
1400000US24001000500,"Census Tract 5, Allegany County, Maryland",1780,709,601,122,547,108,346,287,169,174,59,225,167,144,98,58,128,114,89,74,14,372,372,271,147,0
1400000US24001000600,"Census Tract 6, Allegany County, Maryland",2729,774,767,301,591,7,581,561,371,359,20,837,837,743,202,0,193,193,170,65,0,344,327,327,70,17
1400000US24001000700,"Census Tract 7, Allegany County, Maryland",3648,1195,1015,232,906,180,1300,1187,388,952,113,519,511,397,233,8,516,499,344,209,17,118,118,106,47,0
1400000US24001000800,"Census Tract 8, Allegany County, Maryland",2232,927,870,168,814,57,624,558,177,456,66,412,375,249,181,37,167,159,132,45,8,102,102,102,15,0
1400000US24001001000,"Census Tract 10, Allegany County, Maryland",2391,828,768,241,747,60,932,829,251,667,103,262,219,189,131,43,228,200,158,63,28,141,133,126,7,8
1400000US24001001100,"Census Tract 11, Allegany County, Maryland",1249,302,297,99,259,5,349,311,140,213,38,312,200,162,43,112,117,117,117,28,0,169,169,155,62,0
1400000US24001001200,"Census Tract 12, Allegany County, Maryland",2996,442,366,179,253,76,474,416,264,268,58,562,562,465,243,0,489,489,374,228,0,1029,1021,959,233,8
1400000US24001001300,"Census Tract 13, Allegany County, Maryland",2105,380,361,159,286,19,430,415,314,204,15,513,495,449,129,18,409,404,389,93,5,373,365,339,26,8
1400000US24001001401,"Census Tract 14.01, Allegany County, Maryland",3793,365,365,128,323,0,547,526,365,351,21,688,573,472,269,115,509,509,424,181,0,1684,1533,1494,246,151
1400000US24001001402,"Census Tract 14.02, Allegany County, Maryland",1517,333,333,182,226,0,315,305,155,228,10,320,311,303,69,9,173,166,149,27,7,376,311,265,66,65
1400000US24001001502,"Census Tract 15.02, Allegany County, Maryland",1902,212,202,78,202,10,715,715,419,470,0,443,411,381,183,32,266,252,229,64,14,266,252,247,46,14
1400000US24001001503,"Census Tract 15.03, Allegany County, Maryland",1882,215,195,87,169,20,515,415,226,270,100,554,533,449,156,21,215,204,159,65,11,383,340,279,97,43
1400000US24001001600,"Census Tract 16, Allegany County, Maryland",1617,215,203,117,148,12,310,247,198,135,63,314,314,309,116,0,189,185,175,64,4,589,589,495,140,0
1400000US24001001700,"Census Tract 17, Allegany County, Maryland",5119,982,931,672,437,51,1485,1404,994,751,81,771,771,722,161,0,599,564,552,56,35,1282,1282,1282,95,0
1400000US24001001800,"Census Tract 18, Allegany County, Maryland",2829,899,850,734,238,49,592,563,425,188,29,504,485,460,127,19,365,260,222,47,105,469,459,459,75,10
1400000US24001001900,"Census Tract 19, Allegany County, Maryland",2882,359,357,102,338,2,752,698,383,463,54,658,631,521,274,27,508,484,391,212,24,605,604,547,193,1
1400000US24001002000,"Census Tract 20, Allegany County, Maryland",5787,1300,1140,405,938,160,1461,1403,922,950,58,1006,1006,908,478,0,528,511,387,214,17,1492,1425,1353,88,67
1400000US24001002100,"Census Tract 21, Allegany County, Maryland",3117,597,569,174,528,28,823,778,437,598,45,664,656,510,251,8,610,575,497,111,35,423,410,363,85,13
1400000US24001002200,"Census Tract 22, Allegany County, Maryland",3767,712,685,238,652,27,1245,1183,448,907,62,962,909,683,386,53,531,521,368,201,10,317,317,308,42,0
1400000US24003701101,"Census Tract 7011.01, Anne Arundel County, Maryland",4036,180,180,125,98,0,395,386,219,306,9,360,350,306,112,10,403,392,339,134,11,2698,2632,2528,448,66
1400000US24003701102,"Census Tract 7011.02, Anne Arundel County, Maryland",8141,300,290,164,238,10,1059,1011,633,589,48,1651,986,675,449,665,1247,1247,1233,194,0,3884,3774,3444,610,110
1400000US24003701200,"Census Tract 7012, Anne Arundel County, Maryland",8656,204,193,105,164,11,478,458,393,217,20,1025,937,892,191,88,851,836,784,236,15,6098,5929,5494,1146,169
1400000US24003701300,"Census Tract 7013, Anne Arundel County, Maryland",7709,564,489,110,489,75,694,658,323,491,36,481,481,465,134,0,930,930,826,277,0,5040,5025,4814,785,15
1400000US24003701400,"Census Tract 7014, Anne Arundel County, Maryland",3488,326,297,138,253,29,372,372,277,232,0,243,243,233,106,0,312,303,303,55,9,2235,2227,2092,496,8
1400000US24003702100,"Census Tract 7021, Anne Arundel County, Maryland",7106,405,327,247,141,78,632,607,400,437,25,497,481,387,195,16,673,631,480,240,42,4899,4798,4595,697,101
1400000US24003702204,"Census Tract 7022.04, Anne Arundel County, Maryland",4166,67,48,41,22,19,226,215,191,112,11,314,314,314,92,0,365,343,336,42,22,3194,3141,3075,513,53
1400000US24003702205,"Census Tract 7022.05, Anne Arundel County, Maryland",5685,111,93,71,77,18,392,362,349,116,30,465,448,437,124,17,1178,1131,1064,238,47,3539,3429,3150,725,110
1400000US24003702206,"Census Tract 7022.06, Anne Arundel County, Maryland",6488,58,44,44,18,14,357,357,292,159,0,540,508,411,130,32,1003,1003,948,328,0,4530,4367,4270,385,163
1400000US24003702208,"Census Tract 7022.08, Anne Arundel County, Maryland",7000,99,67,42,39,32,341,321,239,154,20,733,689,689,44,44,1034,906,887,65,128,4793,4743,4561,481,50
1400000US24003702209,"Census Tract 7022.09, Anne Arundel County, Maryland",4435,56,56,27,39,0,187,187,141,132,0,82,82,82,9,0,276,267,267,49,9,3834,3785,3747,160,49
1400000US24003702300,"Census Tract 7023, Anne Arundel County, Maryland",5541,130,118,108,54,12,333,316,203,233,17,392,392,345,180,0,644,624,594,87,20,4042,3949,3831,654,93
1400000US24003702402,"Census Tract 7024.02, Anne Arundel County, Maryland",6140,324,324,156,241,0,562,503,447,225,59,523,523,504,116,0,932,932,907,295,0,3799,3673,3450,1107,126
1400000US24003702500,"Census Tract 7025, Anne Arundel County, Maryland",5912,619,466,138,397,153,636,449,274,259,187,1138,848,700,313,290,953,802,413,450,151,2566,2555,2386,651,11
1400000US24003702601,"Census Tract 7026.01, Anne Arundel County, Maryland",5470,160,145,84,90,15,820,820,543,387,0,902,847,668,338,55,671,627,627,93,44,2917,2891,2791,430,26
1400000US24003702602,"Census Tract 7026.02, Anne Arundel County, Maryland",5775,148,144,77,68,4,514,513,386,362,1,632,595,460,318,37,532,519,502,140,13,3949,3885,3725,533,64
1400000US24003702701,"Census Tract 7027.01, Anne Arundel County, Maryland",4130,117,109,76,87,8,582,565,539,182,17,570,530,436,130,40,569,511,483,67,58,2292,2266,2188,205,26
1400000US24003702702,"Census Tract 7027.02, Anne Arundel County, Maryland",3715,98,98,98,17,0,123,123,110,99,0,205,205,193,129,0,161,161,137,106,0,3128,3108,2936,730,20
1400000US24003706101,"Census Tract 7061.01, Anne Arundel County, Maryland",3333,443,434,77,394,9,631,562,329,252,69,137,137,124,79,0,486,450,450,76,36,1636,1624,1539,341,12
1400000US24003706301,"Census Tract 7063.01, Anne Arundel County, Maryland",4210,384,352,183,301,32,738,735,332,573,3,1046,1015,948,362,31,424,424,340,215,0,1618,1431,1353,331,187
1400000US24003706302,"Census Tract 7063.02, Anne Arundel County, Maryland",3096,205,193,111,145,12,451,299,243,145,152,336,336,304,147,0,386,362,346,55,24,1718,1694,1652,341,24
1400000US24003706401,"Census Tract 7064.01, Anne Arundel County, Maryland",7638,248,164,38,164,84,1536,1138,793,506,398,2057,1473,662,855,584,725,443,424,131,282,3072,2579,1967,969,493
1400000US24003706402,"Census Tract 7064.02, Anne Arundel County, Maryland",3019,568,471,135,388,97,529,415,173,312,114,300,287,185,172,13,305,244,217,69,61,1317,1223,984,373,94
1400000US24003706500,"Census Tract 7065, Anne Arundel County, Maryland",5186,465,436,182,331,29,386,343,172,271,43,698,542,429,151,156,763,747,517,329,16,2874,2710,2594,524,164
1400000US24003706600,"Census Tract 7066, Anne Arundel County, Maryland",5350,512,457,216,335,55,702,634,146,523,68,791,617,537,226,174,408,401,377,103,7,2937,2919,2875,377,18
1400000US24003706700,"Census Tract 7067, Anne Arundel County, Maryland",432,10,10,6,4,0,12,12,12,4,0,39,39,39,5,0,214,196,182,60,18,157,152,148,45,5
1400000US24003707001,"Census Tract 7070.01, Anne Arundel County, Maryland",6208,389,356,217,247,33,597,541,406,461,56,844,827,677,379,17,989,944,787,314,45,3389,3244,3071,399,145
1400000US24003707002,"Census Tract 7070.02, Anne Arundel County, Maryland",4861,355,351,248,139,4,259,248,210,99,11,584,568,504,172,16,1126,1116,992,291,10,2537,2509,2350,436,28
1400000US24003708001,"Census Tract 7080.01, Anne Arundel County, Maryland",3738,254,233,137,157,21,345,328,199,197,17,457,420,395,141,37,371,371,361,150,0,2311,2271,2170,445,40
1400000US24003708004,"Census Tract 7080.04, Anne Arundel County, Maryland",5978,1143,1066,278,899,77,507,468,383,287,39,1170,1110,971,256,60,1133,1073,937,214,60,2025,2008,1886,379,17
1400000US24003730100,"Census Tract 7301, Anne Arundel County, Maryland",10696,296,264,227,159,32,717,652,396,445,65,1247,1170,1017,237,77,2058,2008,1847,376,50,6378,6295,6126,561,83
1400000US24003730203,"Census Tract 7302.03, Anne Arundel County, Maryland",5531,956,956,188,884,0,1369,1181,808,456,188,1381,1034,729,544,347,713,678,477,251,35,1112,1046,897,296,66
1400000US24003730204,"Census Tract 7302.04, Anne Arundel County, Maryland",5957,587,587,102,555,0,1211,1211,707,601,0,1642,1558,964,984,84,626,595,552,197,31,1891,1815,1701,367,76
1400000US24003730300,"Census Tract 7303, Anne Arundel County, Maryland",3470,164,150,100,106,14,267,224,135,208,43,590,508,401,183,82,669,498,391,146,171,1780,1668,1501,397,112
1400000US24003730401,"Census Tract 7304.01, Anne Arundel County, Maryland",5262,471,461,152,389,10,844,774,365,556,70,739,666,589,192,73,1039,987,832,245,52,2169,2091,1904,389,78
1400000US24003730402,"Census Tract 7304.02, Anne Arundel County, Maryland",6164,1072,992,430,728,80,938,886,488,553,52,974,853,639,310,121,1278,1060,1023,178,218,1902,1740,1327,566,162
1400000US24003730502,"Census Tract 7305.02, Anne Arundel County, Maryland",5869,613,534,106,494,79,660,578,399,331,82,1389,1358,937,595,31,486,463,427,145,23,2721,2591,2508,361,130
1400000US24003730504,"Census Tract 7305.04, Anne Arundel County, Maryland",7418,323,199,82,153,124,421,411,342,124,10,1404,1334,1297,314,70,1695,1607,1576,132,88,3575,3290,3171,532,285
1400000US24003730505,"Census Tract 7305.05, Anne Arundel County, Maryland",4657,387,345,178,231,42,1424,1180,580,802,244,1337,1243,819,546,94,664,660,635,170,4,845,828,735,110,17
1400000US24003730506,"Census Tract 7305.06, Anne Arundel County, Maryland",3416,671,628,225,462,43,1119,1080,547,610,39,912,728,586,204,184,359,328,284,55,31,355,332,325,27,23
1400000US24003730601,"Census Tract 7306.01, Anne Arundel County, Maryland",6993,157,157,157,82,0,199,199,168,102,0,444,444,424,187,0,335,335,278,136,0,5858,5769,5678,870,89
1400000US24003730603,"Census Tract 7306.03, Anne Arundel County, Maryland",3023,92,92,81,34,0,117,110,96,48,7,502,460,385,181,42,192,192,161,31,0,2120,2097,2025,341,23
1400000US24003730604,"Census Tract 7306.04, Anne Arundel County, Maryland",7148,291,259,231,188,32,327,317,197,194,10,316,289,289,178,27,532,532,462,243,0,5682,5662,5639,494,20
1400000US24003730700,"Census Tract 7307, Anne Arundel County, Maryland",7429,181,181,138,96,0,330,330,303,129,0,566,566,387,358,0,1232,1173,1068,247,59,5120,4936,4733,812,184
1400000US24003730800,"Census Tract 7308, Anne Arundel County, Maryland",2463,74,63,58,41,11,122,117,101,58,5,105,99,99,61,6,138,121,109,58,17,2024,1971,1934,286,53
1400000US24003730901,"Census Tract 7309.01, Anne Arundel County, Maryland",2483,39,39,24,30,0,247,247,226,111,0,211,211,186,50,0,210,203,181,103,7,1776,1767,1739,278,9
1400000US24003730902,"Census Tract 7309.02, Anne Arundel County, Maryland",4090,119,119,82,103,0,176,163,125,79,13,289,235,189,105,54,324,324,324,53,0,3182,3163,3052,579,19
1400000US24003731002,"Census Tract 7310.02, Anne Arundel County, Maryland",3568,164,158,140,43,6,393,365,312,153,28,343,304,261,151,39,353,317,300,140,36,2315,2156,2006,388,159
1400000US24003731003,"Census Tract 7310.03, Anne Arundel County, Maryland",4142,99,89,71,56,10,411,411,401,116,0,587,580,520,153,7,586,560,533,157,26,2459,2440,2302,335,19
1400000US24003731004,"Census Tract 7310.04, Anne Arundel County, Maryland",4349,200,192,127,152,8,183,158,136,71,25,661,632,576,144,29,511,511,380,146,0,2794,2711,2623,414,83
1400000US24003731102,"Census Tract 7311.02, Anne Arundel County, Maryland",7606,262,262,132,262,0,529,443,384,172,86,761,678,628,144,83,781,748,657,163,33,5273,5203,5038,594,70
1400000US24003731103,"Census Tract 7311.03, Anne Arundel County, Maryland",5132,313,230,206,43,83,358,294,237,114,64,514,505,385,292,9,676,656,599,132,20,3271,3225,3101,576,46
1400000US24003731104,"Census Tract 7311.04, Anne Arundel County, Maryland",4296,92,92,25,92,0,331,241,143,197,90,516,505,455,90,11,662,630,586,94,32,2695,2553,2517,286,142
1400000US24003731105,"Census Tract 7311.05, Anne Arundel County, Maryland",3507,161,130,91,85,31,392,347,229,167,45,494,481,441,78,13,572,572,463,190,0,1888,1848,1753,376,40
1400000US24003731201,"Census Tract 7312.01, Anne Arundel County, Maryland",6395,290,290,226,173,0,252,252,162,156,0,404,386,355,115,18,711,711,537,244,0,4738,4631,4560,742,107
1400000US24003731202,"Census Tract 7312.02, Anne Arundel County, Maryland",7840,155,155,60,141,0,797,783,443,628,14,1024,926,776,338,98,998,834,765,278,164,4866,4768,4525,614,98
1400000US24003731203,"Census Tract 7312.03, Anne Arundel County, Maryland",7066,137,100,82,55,37,595,562,465,267,33,839,839,726,313,0,871,853,781,251,18,4624,4553,4466,528,71
1400000US24003731204,"Census Tract 7312.04, Anne Arundel County, Maryland",6235,373,341,240,262,32,611,430,414,157,181,1485,1437,1056,522,48,477,477,457,20,0,3289,3178,3070,220,111
1400000US24003731303,"Census Tract 7313.03, Anne Arundel County, Maryland",6792,288,259,161,154,29,1204,1041,618,751,163,538,531,483,244,7,706,706,625,146,0,4056,4002,3899,558,54
1400000US24003731306,"Census Tract 7313.06, Anne Arundel County, Maryland",5891,381,381,162,343,0,613,548,394,321,65,448,436,316,177,12,1031,1013,870,293,18,3418,3280,3080,454,138
1400000US24003731307,"Census Tract 7313.07, Anne Arundel County, Maryland",6472,502,502,284,325,0,819,667,499,277,152,861,786,689,244,75,1092,1039,937,153,53,3198,3098,3026,204,100
1400000US24003731308,"Census Tract 7313.08, Anne Arundel County, Maryland",3883,257,238,133,202,19,189,181,117,118,8,612,600,485,257,12,694,687,577,181,7,2131,2024,1758,527,107
1400000US24003731309,"Census Tract 7313.09, Anne Arundel County, Maryland",5830,319,272,100,223,47,1044,1017,515,652,27,904,858,743,149,46,1094,1034,727,357,60,2469,2419,2239,423,50
1400000US24003731310,"Census Tract 7313.10, Anne Arundel County, Maryland",5561,230,230,87,177,0,733,716,389,425,17,1031,996,818,546,35,732,693,630,287,39,2835,2573,2449,314,262
1400000US24003731311,"Census Tract 7313.11, Anne Arundel County, Maryland",7941,216,173,56,150,43,589,589,498,227,0,997,965,887,312,32,1360,1302,1159,382,58,4779,4608,4198,574,171
1400000US24003740102,"Census Tract 7401.02, Anne Arundel County, Maryland",10167,475,370,93,294,105,1000,887,658,327,113,1243,1243,1016,379,0,921,910,803,202,11,6528,6215,6029,773,313
1400000US24003740103,"Census Tract 7401.03, Anne Arundel County, Maryland",8501,395,295,191,254,100,654,602,332,428,52,828,767,642,302,61,1429,1345,1194,424,84,5195,5177,4770,1077,18
1400000US24003740104,"Census Tract 7401.04, Anne Arundel County, Maryland",8414,659,601,145,497,58,961,867,594,587,94,1154,1154,893,397,0,971,876,821,126,95,4669,4595,4292,527,74
1400000US24003740105,"Census Tract 7401.05, Anne Arundel County, Maryland",3724,346,323,19,323,23,836,731,428,447,105,678,605,556,84,73,657,591,562,42,66,1207,1038,1022,91,169
1400000US24003740201,"Census Tract 7402.01, Anne Arundel County, Maryland",7453,366,350,256,331,16,1416,1354,589,920,62,1172,1036,918,303,136,1348,1348,1187,297,0,3151,2900,2754,573,251
1400000US24003740203,"Census Tract 7402.03, Anne Arundel County, Maryland",6328,230,205,139,145,25,271,255,168,166,16,533,497,476,212,36,802,748,722,169,54,4492,4352,4295,545,140
1400000US24003740303,"Census Tract 7403.03, Anne Arundel County, Maryland",4497,462,208,62,162,254,302,292,265,126,10,680,680,530,296,0,550,461,443,132,89,2503,2439,2382,187,64
1400000US24003740304,"Census Tract 7403.04, Anne Arundel County, Maryland",5044,321,310,201,211,11,390,335,263,134,55,586,555,544,121,31,838,825,777,193,13,2909,2846,2742,297,63
1400000US24003740305,"Census Tract 7403.05, Anne Arundel County, Maryland",11299,990,860,322,673,130,1280,1015,550,604,265,1376,1316,1099,492,60,2105,2067,1809,550,38,5548,5310,5036,841,238
1400000US24003740400,"Census Tract 7404, Anne Arundel County, Maryland",0,0,0,0,0,0,0,0,0,0,0,0,0,0,0,0,0,0,0,0,0,0,0,0,0,0
1400000US24003740500,"Census Tract 7405, Anne Arundel County, Maryland",10647,210,210,169,41,0,741,617,332,348,124,1070,1050,891,297,20,1670,1453,1384,135,217,6956,6476,6194,642,480
1400000US24003740601,"Census Tract 7406.01, Anne Arundel County, Maryland",3231,96,96,96,11,0,775,747,721,44,28,596,596,596,25,0,573,524,524,20,49,1191,1191,1191,59,0
1400000US24003740602,"Census Tract 7406.02, Anne Arundel County, Maryland",2676,344,344,344,0,0,611,576,570,6,35,692,661,636,282,31,327,327,327,33,0,702,684,642,155,18
1400000US24003740603,"Census Tract 7406.03, Anne Arundel County, Maryland",1213,80,67,27,40,13,275,275,257,18,0,334,334,310,45,0,42,42,42,0,0,482,462,462,4,20
1400000US24003740701,"Census Tract 7407.01, Anne Arundel County, Maryland",5614,259,205,100,183,54,424,370,292,194,54,1099,1063,1016,251,36,878,849,807,281,29,2954,2878,2849,336,76
1400000US24003740702,"Census Tract 7407.02, Anne Arundel County, Maryland",9430,346,346,334,231,0,790,790,710,457,0,663,643,643,378,20,1544,1529,1425,314,15,6087,6009,5888,527,78
1400000US24003740800,"Census Tract 7408, Anne Arundel County, Maryland",4510,158,138,121,73,20,457,388,310,253,69,504,482,440,215,22,477,455,447,137,22,2914,2885,2748,669,29
1400000US24003740900,"Census Tract 7409, Anne Arundel County, Maryland",7726,522,458,293,313,64,935,656,304,468,279,756,596,455,380,160,1830,1769,1364,489,61,3683,3614,3543,475,69
1400000US24003741000,"Census Tract 7410, Anne Arundel County, Maryland",2408,52,47,37,38,5,158,130,65,106,28,119,112,92,26,7,289,289,233,92,0,1790,1741,1704,206,49
1400000US24003750101,"Census Tract 7501.01, Anne Arundel County, Maryland",4245,531,397,175,345,134,848,822,287,690,26,681,619,358,344,62,1215,1165,814,467,50,970,904,779,218,66
1400000US24003750102,"Census Tract 7501.02, Anne Arundel County, Maryland",2885,510,445,125,431,65,430,397,158,297,33,502,420,299,164,82,639,608,314,342,31,804,782,691,130,22
1400000US24003750201,"Census Tract 7502.01, Anne Arundel County, Maryland",3031,571,528,239,387,43,784,717,375,467,67,360,295,237,122,65,441,273,159,167,168,875,775,500,365,100
1400000US24003750202,"Census Tract 7502.02, Anne Arundel County, Maryland",3369,263,242,92,235,21,608,570,213,491,38,339,320,197,229,19,1006,925,401,574,81,1153,1141,1041,189,12
1400000US24003750203,"Census Tract 7502.03, Anne Arundel County, Maryland",1076,73,55,36,34,18,152,130,115,58,22,322,322,228,146,0,198,198,184,30,0,331,331,295,55,0
1400000US24003750300,"Census Tract 7503, Anne Arundel County, Maryland",2943,277,277,147,193,0,289,255,154,178,34,428,382,302,145,46,307,307,287,24,0,1642,1530,1376,343,112
1400000US24003750400,"Census Tract 7504, Anne Arundel County, Maryland",3934,187,168,94,141,19,477,467,317,361,10,462,449,394,244,13,467,401,387,168,66,2341,2302,2168,355,39
1400000US24003750801,"Census Tract 7508.01, Anne Arundel County, Maryland",6344,201,166,84,127,35,750,647,504,462,103,728,590,552,177,138,1146,1119,1034,189,27,3519,3426,3255,544,93
1400000US24003750803,"Census Tract 7508.03, Anne Arundel County, Maryland",7536,902,843,166,792,59,1761,1385,749,830,376,2272,2031,1203,1042,241,1355,1323,1110,320,32,1246,1212,1141,167,34
1400000US24003750804,"Census Tract 7508.04, Anne Arundel County, Maryland",3576,609,601,177,540,8,596,576,418,445,20,642,642,522,227,0,541,531,454,145,10,1188,1032,975,93,156
1400000US24003750900,"Census Tract 7509, Anne Arundel County, Maryland",2936,297,286,153,266,11,538,463,201,353,75,645,527,382,259,118,431,407,278,230,24,1025,1010,973,143,15
1400000US24003751000,"Census Tract 7510, Anne Arundel County, Maryland",4174,181,145,110,90,36,1107,1008,502,664,99,1127,898,724,298,229,451,398,352,121,53,1308,1258,1190,149,50
1400000US24003751102,"Census Tract 7511.02, Anne Arundel County, Maryland",3793,524,501,264,392,23,723,723,450,422,0,844,787,618,320,57,405,376,331,159,29,1297,1221,1130,177,76
1400000US24003751103,"Census Tract 7511.03, Anne Arundel County, Maryland",5083,329,329,44,329,0,1097,1025,696,715,72,1272,1133,950,508,139,384,369,324,162,15,2001,1811,1470,629,190
1400000US24003751200,"Census Tract 7512, Anne Arundel County, Maryland",4214,122,122,29,113,0,573,497,411,266,76,341,311,253,117,30,627,627,604,112,0,2551,2420,2193,349,131
1400000US24003751400,"Census Tract 7514, Anne Arundel County, Maryland",3859,223,161,83,161,62,508,436,362,166,72,410,318,282,142,92,345,337,316,125,8,2373,2280,2203,375,93
1400000US24003751500,"Census Tract 7515, Anne Arundel County, Maryland",6924,551,452,247,249,99,806,698,426,426,108,1720,1596,1373,372,124,1649,1634,1279,480,15,2198,2011,1820,319,187
1400000US24003751600,"Census Tract 7516, Anne Arundel County, Maryland",4897,340,328,247,328,12,672,658,566,502,14,841,841,646,518,0,755,665,558,478,90,2289,2289,2170,867,0
1400000US24003751700,"Census Tract 7517, Anne Arundel County, Maryland",2756,98,98,50,48,0,108,108,77,72,0,74,74,74,46,0,200,200,177,76,0,2276,2258,2187,294,18
1400000US24003980000,"Census Tract 9800, Anne Arundel County, Maryland",0,0,0,0,0,0,0,0,0,0,0,0,0,0,0,0,0,0,0,0,0,0,0,0,0,0
1400000US24003990000,"Census Tract 9900, Anne Arundel County, Maryland",0,0,0,0,0,0,0,0,0,0,0,0,0,0,0,0,0,0,0,0,0,0,0,0,0,0
1400000US24005400100,"Census Tract 4001, Baltimore County, Maryland",4444,489,489,387,489,0,1363,1363,579,1348,0,771,771,675,463,0,336,336,336,223,0,1485,1383,1258,318,102
1400000US24005400200,"Census Tract 4002, Baltimore County, Maryland",2278,235,153,77,76,82,400,286,236,88,114,338,299,287,75,39,403,389,359,47,14,902,902,890,63,0
1400000US24005400400,"Census Tract 4004, Baltimore County, Maryland",5544,225,210,170,54,15,537,537,409,488,0,648,631,486,339,17,534,510,467,175,24,3600,3371,3128,461,229
1400000US24005400500,"Census Tract 4005, Baltimore County, Maryland",2490,85,85,70,62,0,123,123,97,83,0,140,140,111,58,0,190,190,190,32,0,1952,1947,1920,217,5
1400000US24005400600,"Census Tract 4006, Baltimore County, Maryland",2902,171,161,70,142,10,340,315,108,268,25,535,471,357,156,64,514,492,430,171,22,1342,1313,1298,72,29
1400000US24005400701,"Census Tract 4007.01, Baltimore County, Maryland",2896,215,177,128,72,38,392,392,258,186,0,670,661,623,126,9,418,309,301,38,109,1201,1121,1101,54,80
1400000US24005400702,"Census Tract 4007.02, Baltimore County, Maryland",1930,64,59,24,43,5,205,195,144,81,10,323,260,185,109,63,134,130,130,4,4,1204,1119,1090,107,85
1400000US24005400800,"Census Tract 4008, Baltimore County, Maryland",2524,70,70,54,52,0,431,420,202,299,11,501,367,259,119,134,348,282,282,37,66,1174,1167,1056,218,7
1400000US24005400900,"Census Tract 4009, Baltimore County, Maryland",2043,233,180,82,149,53,388,306,145,218,82,329,311,293,44,18,284,248,218,61,36,809,800,745,87,9
1400000US24005401000,"Census Tract 4010, Baltimore County, Maryland",2153,98,94,65,68,4,359,339,157,207,20,244,244,222,64,0,166,166,166,28,0,1286,1277,1238,122,9
1400000US24005401101,"Census Tract 4011.01, Baltimore County, Maryland",5871,865,700,196,570,165,524,516,357,232,8,1675,1394,1180,361,281,1048,863,822,148,185,1759,1759,1649,345,0
1400000US24005401102,"Census Tract 4011.02, Baltimore County, Maryland",1002,146,142,62,106,4,163,163,112,80,0,251,243,203,63,8,157,157,151,43,0,285,259,226,56,26
1400000US24005401200,"Census Tract 4012, Baltimore County, Maryland",2873,259,247,165,191,12,344,344,253,224,0,579,511,465,243,68,538,511,355,253,27,1153,1093,961,216,60
1400000US24005401301,"Census Tract 4013.01, Baltimore County, Maryland",3621,287,214,78,214,73,726,684,441,337,42,1085,1003,464,731,82,432,409,342,139,23,1091,1071,990,273,20
1400000US24005401302,"Census Tract 4013.02, Baltimore County, Maryland",2728,459,433,254,336,26,670,617,522,201,53,480,460,449,64,20,455,362,296,93,93,664,653,543,152,11
1400000US24005401400,"Census Tract 4014, Baltimore County, Maryland",1718,50,50,50,10,0,117,117,44,117,0,212,212,205,23,0,330,237,189,77,93,1009,975,948,145,34
1400000US24005401503,"Census Tract 4015.03, Baltimore County, Maryland",6451,146,146,129,146,0,782,761,552,470,21,851,851,774,246,0,1187,1164,1057,273,23,3485,3433,3354,289,52
1400000US24005401504,"Census Tract 4015.04, Baltimore County, Maryland",6426,198,123,40,97,75,767,640,389,305,127,1394,1216,853,648,178,1338,1266,985,463,72,2729,2582,2421,414,147
1400000US24005401505,"Census Tract 4015.05, Baltimore County, Maryland",4332,492,476,235,425,16,757,757,606,286,0,601,545,380,283,56,726,693,549,168,33,1756,1756,1619,362,0
1400000US24005401506,"Census Tract 4015.06, Baltimore County, Maryland",5197,318,279,181,194,39,821,665,424,293,156,757,640,590,74,117,1175,1083,903,207,92,2126,2114,2052,136,12
1400000US24005401507,"Census Tract 4015.07, Baltimore County, Maryland",6056,179,179,46,145,0,2569,2153,1406,862,416,1078,634,532,117,444,579,561,454,146,18,1651,1622,1529,175,29
1400000US24005402201,"Census Tract 4022.01, Baltimore County, Maryland",3234,154,145,98,89,9,297,290,148,207,7,524,510,483,110,14,607,547,489,167,60,1652,1638,1582,217,14
1400000US24005402202,"Census Tract 4022.02, Baltimore County, Maryland",1513,79,66,18,60,13,42,36,8,28,6,123,123,51,83,0,251,251,222,67,0,1018,920,849,185,98
1400000US24005402302,"Census Tract 4023.02, Baltimore County, Maryland",5504,415,370,39,362,45,676,603,306,392,73,841,744,439,420,97,779,768,647,207,11,2793,2624,2261,561,169
1400000US24005402303,"Census Tract 4023.03, Baltimore County, Maryland",6620,615,476,261,375,139,947,771,463,382,176,1291,1183,1007,311,108,1155,1092,809,473,63,2612,2541,2374,486,71
1400000US24005402304,"Census Tract 4023.04, Baltimore County, Maryland",3643,366,366,51,346,0,575,543,407,337,32,831,751,498,333,80,807,789,700,184,18,1064,1055,904,422,9
1400000US24005402305,"Census Tract 4023.05, Baltimore County, Maryland",2124,291,148,53,115,143,471,405,239,281,66,274,274,204,178,0,540,481,471,43,59,548,526,443,134,22
1400000US24005402306,"Census Tract 4023.06, Baltimore County, Maryland",3941,712,601,386,342,111,846,738,495,256,108,619,481,430,129,138,337,303,235,117,34,1427,1354,1222,218,73
1400000US24005402307,"Census Tract 4023.07, Baltimore County, Maryland",6217,972,953,204,749,19,1027,926,463,578,101,1735,1688,1300,693,47,966,966,887,175,0,1517,1502,1426,111,15
1400000US24005402403,"Census Tract 4024.03, Baltimore County, Maryland",1970,234,228,127,152,6,386,354,211,198,32,274,267,224,163,7,524,506,454,180,18,552,535,509,92,17
1400000US24005402404,"Census Tract 4024.04, Baltimore County, Maryland",5289,810,620,116,587,190,1260,1144,609,685,116,1054,1054,722,694,0,1022,983,799,404,39,1143,1143,1033,240,0
1400000US24005402405,"Census Tract 4024.05, Baltimore County, Maryland",3512,411,400,146,367,11,657,615,402,308,42,876,788,555,408,88,630,570,411,168,60,938,847,690,233,91
1400000US24005402406,"Census Tract 4024.06, Baltimore County, Maryland",6087,750,662,289,502,88,827,582,264,409,245,1799,1600,1424,296,199,600,600,584,79,0,2111,2091,1841,484,20
1400000US24005402407,"Census Tract 4024.07, Baltimore County, Maryland",1451,319,319,136,245,0,319,298,173,167,21,103,103,103,28,0,253,244,154,100,9,457,423,406,36,34
1400000US24005402503,"Census Tract 4025.03, Baltimore County, Maryland",4942,688,629,191,566,59,1064,934,710,396,130,582,571,511,82,11,1156,1156,773,567,0,1452,1374,1242,197,78
1400000US24005402504,"Census Tract 4025.04, Baltimore County, Maryland",4149,294,294,94,286,0,272,272,105,223,0,536,531,465,169,5,759,736,617,172,23,2288,2218,2079,580,70
1400000US24005402505,"Census Tract 4025.05, Baltimore County, Maryland",3858,455,455,272,306,0,586,540,294,314,46,496,400,284,186,96,932,932,882,117,0,1389,1369,1244,145,20
1400000US24005402506,"Census Tract 4025.06, Baltimore County, Maryland",4476,115,102,36,92,13,726,620,477,261,106,427,427,350,219,0,924,866,738,271,58,2284,2264,2035,363,20
1400000US24005402509,"Census Tract 4025.09, Baltimore County, Maryland",9593,320,320,253,287,0,1133,1133,955,332,0,2168,1926,1567,545,242,1490,1380,1360,165,110,4482,4409,4158,697,73
1400000US24005402602,"Census Tract 4026.02, Baltimore County, Maryland",2140,261,230,83,184,31,364,336,247,171,28,317,283,283,37,34,358,353,315,40,5,840,773,703,160,67
1400000US24005402603,"Census Tract 4026.03, Baltimore County, Maryland",6444,167,167,108,135,0,252,245,146,146,7,887,859,727,455,28,640,608,541,154,32,4498,4233,3932,499,265
1400000US24005402604,"Census Tract 4026.04, Baltimore County, Maryland",6097,264,264,134,215,0,1461,1341,702,810,120,687,665,625,288,22,1059,1009,868,327,50,2626,2566,2260,610,60
1400000US24005403100,"Census Tract 4031, Baltimore County, Maryland",2238,210,196,63,174,14,283,283,202,190,0,459,429,354,180,30,253,246,183,104,7,1033,930,690,344,103
1400000US24005403201,"Census Tract 4032.01, Baltimore County, Maryland",3345,219,209,163,122,10,529,481,302,276,48,803,710,435,384,93,474,456,370,188,18,1320,1247,1082,349,73
1400000US24005403202,"Census Tract 4032.02, Baltimore County, Maryland",2167,174,168,133,79,6,393,371,183,228,22,452,408,334,146,44,485,431,360,171,54,663,573,548,112,90
1400000US24005403300,"Census Tract 4033, Baltimore County, Maryland",2504,108,93,52,69,15,326,240,175,154,86,475,444,377,148,31,309,291,243,81,18,1286,1253,1041,302,33
1400000US24005403401,"Census Tract 4034.01, Baltimore County, Maryland",3300,383,383,200,330,0,538,528,348,369,10,446,411,342,165,35,796,796,603,348,0,1137,1126,1063,208,11
1400000US24005403402,"Census Tract 4034.02, Baltimore County, Maryland",5455,854,817,216,714,37,1651,1594,1114,662,57,630,475,382,158,155,393,393,377,121,0,1927,1881,1458,691,46
1400000US24005403500,"Census Tract 4035, Baltimore County, Maryland",5110,277,236,169,132,41,474,474,325,242,0,751,734,628,238,17,630,597,532,157,33,2978,2918,2737,493,60
1400000US24005403601,"Census Tract 4036.01, Baltimore County, Maryland",4784,373,373,186,287,0,550,452,247,346,98,824,774,690,261,50,617,559,478,139,58,2420,2407,2303,365,13
1400000US24005403602,"Census Tract 4036.02, Baltimore County, Maryland",5959,527,489,242,266,38,475,461,301,272,14,703,703,668,64,0,1236,1236,1187,92,0,3018,2978,2774,347,40
1400000US24005403701,"Census Tract 4037.01, Baltimore County, Maryland",7345,681,600,249,408,81,1034,775,422,518,259,1288,1288,878,634,0,1122,1113,1023,386,9,3220,3111,2829,639,109
1400000US24005403702,"Census Tract 4037.02, Baltimore County, Maryland",4800,703,232,68,182,471,657,657,412,408,0,475,475,368,262,0,1076,986,732,357,90,1889,1799,1584,437,90
1400000US24005403801,"Census Tract 4038.01, Baltimore County, Maryland",1659,58,58,29,29,0,39,39,34,34,0,101,72,9,68,29,173,167,150,44,6,1288,1283,1224,223,5
1400000US24005403802,"Census Tract 4038.02, Baltimore County, Maryland",2825,106,75,39,56,31,187,163,67,123,24,55,55,55,24,0,269,258,226,102,11,2208,2170,2099,435,38
1400000US24005403803,"Census Tract 4038.03, Baltimore County, Maryland",3269,264,264,150,223,0,291,291,215,245,0,402,390,231,236,12,250,250,227,89,0,2062,2054,1948,563,8
1400000US24005404101,"Census Tract 4041.01, Baltimore County, Maryland",5720,358,347,92,255,11,1147,1062,781,391,85,799,737,550,265,62,727,719,705,156,8,2689,2683,2560,376,6
1400000US24005404102,"Census Tract 4041.02, Baltimore County, Maryland",5839,293,273,106,273,20,1185,1000,838,325,185,1203,1144,899,278,59,761,653,477,206,108,2397,2084,1877,330,313
1400000US24005404201,"Census Tract 4042.01, Baltimore County, Maryland",6219,473,417,213,299,56,882,658,481,255,224,1339,1316,1158,243,23,1013,856,739,161,157,2512,2439,2128,360,73
1400000US24005404202,"Census Tract 4042.02, Baltimore County, Maryland",7982,1336,994,302,724,342,2010,1702,936,805,308,1648,1359,1126,307,289,1127,942,650,292,185,1861,1593,1450,261,268
1400000US24005404402,"Census Tract 4044.02, Baltimore County, Maryland",6324,549,299,53,261,250,544,513,374,155,31,247,247,247,67,0,777,777,758,68,0,4207,4170,3876,644,37
1400000US24005404403,"Census Tract 4044.03, Baltimore County, Maryland",4894,1366,1071,266,862,295,881,751,486,372,130,836,640,433,263,196,438,438,384,66,0,1373,1366,1346,162,7
1400000US24005404404,"Census Tract 4044.04, Baltimore County, Maryland",4646,695,600,206,554,95,253,234,125,187,19,826,805,597,362,21,897,847,696,254,50,1975,1920,1801,199,55
1400000US24005404501,"Census Tract 4045.01, Baltimore County, Maryland",6934,430,414,194,319,16,852,787,606,322,65,1976,1662,1427,342,314,1219,1219,1038,375,0,2457,2209,1679,707,248
1400000US24005404502,"Census Tract 4045.02, Baltimore County, Maryland",3951,657,647,99,605,10,1044,757,397,475,287,506,485,441,114,21,581,496,421,140,85,1163,809,651,260,354
1400000US24005404600,"Census Tract 4046, Baltimore County, Maryland",2843,138,138,60,128,0,256,248,137,197,8,413,388,282,138,25,185,185,169,79,0,1851,1718,1632,234,133
1400000US24005404800,"Census Tract 4048, Baltimore County, Maryland",1905,75,67,51,67,8,111,103,85,79,8,274,257,216,96,17,176,176,136,114,0,1269,1258,1229,138,11
1400000US24005404900,"Census Tract 4049, Baltimore County, Maryland",4240,439,410,121,363,29,190,182,120,132,8,406,406,350,135,0,160,137,119,49,23,3045,2990,2933,431,55
1400000US24005405000,"Census Tract 4050, Baltimore County, Maryland",4698,398,390,170,285,8,428,404,252,267,24,533,497,349,235,36,658,648,539,155,10,2681,2665,2625,295,16
1400000US24005406000,"Census Tract 4060, Baltimore County, Maryland",6005,195,110,110,92,85,367,367,334,226,0,857,782,685,212,75,895,766,643,381,129,3691,3600,3379,535,91
1400000US24005407001,"Census Tract 4070.01, Baltimore County, Maryland",3008,105,105,52,89,0,353,343,276,152,10,291,283,242,129,8,508,499,421,163,9,1751,1701,1635,253,50
1400000US24005407002,"Census Tract 4070.02, Baltimore County, Maryland",5802,130,130,104,69,0,785,771,485,585,14,577,514,329,308,63,863,841,829,61,22,3447,3417,3184,482,30
1400000US24005408100,"Census Tract 4081, Baltimore County, Maryland",5497,188,188,58,176,0,595,558,488,184,37,295,275,235,48,20,781,661,556,217,120,3638,3495,3441,264,143
1400000US24005408200,"Census Tract 4082, Baltimore County, Maryland",1889,76,50,44,31,26,57,57,34,43,0,153,149,127,78,4,132,132,132,17,0,1471,1456,1373,206,15
1400000US24005408302,"Census Tract 4083.02, Baltimore County, Maryland",2986,188,182,124,76,6,182,182,115,125,0,358,358,344,206,0,194,194,165,77,0,2064,2064,1975,309,0
1400000US24005408303,"Census Tract 4083.03, Baltimore County, Maryland",3361,75,45,45,19,30,128,109,69,49,19,198,189,143,77,9,400,400,335,84,0,2560,2496,2399,307,64
1400000US24005408304,"Census Tract 4083.04, Baltimore County, Maryland",5190,310,295,295,176,15,559,559,461,383,0,874,874,527,538,0,450,417,372,132,33,2997,2944,2856,739,53
1400000US24005408400,"Census Tract 4084, Baltimore County, Maryland",678,93,93,83,76,0,137,137,95,101,0,123,123,112,51,0,73,62,47,21,11,252,244,244,62,8
1400000US24005408502,"Census Tract 4085.02, Baltimore County, Maryland",4589,241,221,160,208,20,380,380,251,300,0,616,552,418,402,64,472,472,369,245,0,2880,2769,2616,592,111
1400000US24005408503,"Census Tract 4085.03, Baltimore County, Maryland",3544,408,378,261,156,30,572,466,279,262,106,815,736,636,250,79,913,776,651,151,137,836,791,761,77,45
1400000US24005408505,"Census Tract 4085.05, Baltimore County, Maryland",3886,314,272,230,49,42,268,267,206,109,1,575,575,537,179,0,948,885,775,209,63,1781,1781,1736,225,0
1400000US24005408506,"Census Tract 4085.06, Baltimore County, Maryland",4487,807,595,163,463,212,1601,1415,772,845,186,1148,927,864,77,221,470,438,414,64,32,461,420,412,63,41
1400000US24005408507,"Census Tract 4085.07, Baltimore County, Maryland",6752,527,362,186,196,165,1841,1603,1084,563,238,1649,1376,1068,350,273,1201,1022,946,128,179,1534,1319,1132,239,215
1400000US24005408601,"Census Tract 4086.01, Baltimore County, Maryland",4015,206,152,129,113,54,302,302,236,195,0,351,343,343,61,8,540,540,522,132,0,2616,2601,2463,405,15
1400000US24005408602,"Census Tract 4086.02, Baltimore County, Maryland",2110,66,66,42,47,0,177,169,152,136,8,213,199,185,92,14,412,392,354,127,20,1242,1215,1190,93,27
1400000US24005408702,"Census Tract 4087.02, Baltimore County, Maryland",2497,110,100,64,44,10,263,242,117,158,21,338,329,248,204,9,252,243,232,49,9,1534,1516,1416,258,18
1400000US24005408703,"Census Tract 4087.03, Baltimore County, Maryland",6395,229,158,30,143,71,696,687,527,359,9,764,764,702,169,0,798,798,689,294,0,3908,3827,3735,513,81
1400000US24005408704,"Census Tract 4087.04, Baltimore County, Maryland",5692,221,208,148,169,13,631,599,505,284,32,795,795,678,207,0,541,541,388,181,0,3504,3330,3219,420,174
1400000US24005408800,"Census Tract 4088, Baltimore County, Maryland",2623,229,207,158,132,22,127,108,100,72,19,309,309,221,135,0,510,489,451,62,21,1448,1433,1387,138,15
1400000US24005408900,"Census Tract 4089, Baltimore County, Maryland",2629,156,156,92,156,0,341,319,253,208,22,241,241,203,107,0,271,260,237,47,11,1620,1609,1554,187,11
1400000US24005410100,"Census Tract 4101, Baltimore County, Maryland",5503,217,217,153,168,0,596,590,508,235,6,548,548,402,233,0,294,294,294,13,0,3848,3806,3694,446,42
1400000US24005410200,"Census Tract 4102, Baltimore County, Maryland",4843,82,82,43,56,0,376,376,274,325,0,312,295,190,199,17,390,355,336,105,35,3683,3683,3629,365,0
1400000US24005411101,"Census Tract 4111.01, Baltimore County, Maryland",2213,205,191,189,58,14,191,191,142,122,0,370,357,314,126,13,255,248,245,85,7,1192,1138,1095,172,54
1400000US24005411102,"Census Tract 4111.02, Baltimore County, Maryland",3056,155,155,94,139,0,337,329,312,99,8,241,241,186,158,0,479,479,377,234,0,1844,1774,1650,340,70
1400000US24005411201,"Census Tract 4112.01, Baltimore County, Maryland",3154,105,105,57,88,0,248,248,192,124,0,206,206,183,109,0,361,361,348,149,0,2234,2209,2177,360,25
1400000US24005411202,"Census Tract 4112.02, Baltimore County, Maryland",3772,199,189,95,164,10,290,290,267,186,0,353,353,314,232,0,358,358,349,89,0,2572,2531,2409,358,41
1400000US24005411302,"Census Tract 4113.02, Baltimore County, Maryland",3667,185,140,79,121,45,433,393,294,169,40,302,302,247,172,0,494,494,494,83,0,2253,2199,2122,191,54
1400000US24005411303,"Census Tract 4113.03, Baltimore County, Maryland",6292,897,858,606,504,39,733,694,441,473,39,991,954,740,391,37,932,887,760,278,45,2739,2576,2544,165,163
1400000US24005411306,"Census Tract 4113.06, Baltimore County, Maryland",5384,538,446,296,261,92,368,368,304,233,0,926,842,797,170,84,887,859,859,99,28,2665,2584,2499,132,81
1400000US24005411307,"Census Tract 4113.07, Baltimore County, Maryland",3850,414,414,173,273,0,372,294,174,155,78,747,679,517,212,68,1078,1063,1018,127,15,1239,1176,1096,111,63
1400000US24005411308,"Census Tract 4113.08, Baltimore County, Maryland",3315,159,149,117,107,10,393,362,338,155,31,360,343,326,162,17,648,648,624,80,0,1755,1725,1624,308,30
1400000US24005411309,"Census Tract 4113.09, Baltimore County, Maryland",8592,451,430,309,339,21,941,930,690,517,11,697,697,642,390,0,637,637,611,254,0,5866,5848,5455,652,18
1400000US24005411404,"Census Tract 4114.04, Baltimore County, Maryland",3645,140,140,89,121,0,388,367,238,215,21,477,412,377,120,65,599,574,533,103,25,2041,1998,1889,213,43
1400000US24005411406,"Census Tract 4114.06, Baltimore County, Maryland",4327,190,171,153,156,19,555,534,272,443,21,716,692,663,145,24,657,621,595,134,36,2209,2189,1951,459,20
1400000US24005411407,"Census Tract 4114.07, Baltimore County, Maryland",10883,1251,1174,628,1117,77,2187,2096,1454,1678,91,1965,1965,1765,1024,0,1413,1237,1054,287,176,4067,4067,3765,797,0
1400000US24005411408,"Census Tract 4114.08, Baltimore County, Maryland",3574,342,328,138,214,14,747,658,364,329,89,664,533,444,115,131,455,407,328,130,48,1366,1328,1216,183,38
1400000US24005411409,"Census Tract 4114.09, Baltimore County, Maryland",5237,300,300,85,239,0,310,290,148,153,20,759,750,675,342,9,761,724,640,210,37,3107,3017,2807,311,90
1400000US24005411410,"Census Tract 4114.10, Baltimore County, Maryland",4783,241,241,155,153,0,520,505,209,353,15,731,628,531,208,103,1013,896,855,165,117,2278,2236,2077,278,42
1400000US24005420100,"Census Tract 4201, Baltimore County, Maryland",3689,331,317,191,233,14,815,705,444,557,110,883,761,612,283,122,861,853,549,392,8,799,754,684,157,45
1400000US24005420200,"Census Tract 4202, Baltimore County, Maryland",2604,287,274,147,214,13,476,435,313,292,41,633,633,482,254,0,382,358,304,77,24,826,814,719,185,12
1400000US24005420301,"Census Tract 4203.01, Baltimore County, Maryland",2515,351,279,17,273,72,638,596,335,374,42,881,828,562,434,53,523,413,253,177,110,122,122,70,52,0
1400000US24005420302,"Census Tract 4203.02, Baltimore County, Maryland",2574,284,186,28,175,98,557,526,251,333,31,518,465,378,151,53,347,308,293,31,39,868,774,614,251,94
1400000US24005420303,"Census Tract 4203.03, Baltimore County, Maryland",1352,105,91,40,86,14,308,296,85,281,12,283,228,117,147,55,186,186,178,23,0,470,466,434,46,4
1400000US24005420401,"Census Tract 4204.01, Baltimore County, Maryland",6230,739,494,141,445,245,1402,1296,274,1186,106,1755,1714,725,1134,41,1215,1187,832,471,28,1119,1056,856,249,63
1400000US24005420402,"Census Tract 4204.02, Baltimore County, Maryland",1972,238,219,56,191,19,411,340,215,212,71,405,352,248,132,53,261,261,256,35,0,657,653,556,170,4
1400000US24005420500,"Census Tract 4205, Baltimore County, Maryland",3350,338,285,110,249,53,865,675,417,417,190,914,835,524,385,79,425,390,390,108,35,808,768,699,186,40
1400000US24005420600,"Census Tract 4206, Baltimore County, Maryland",4200,701,497,104,427,204,913,755,348,517,158,922,829,543,459,93,595,514,395,210,81,1069,899,693,279,170
1400000US24005420701,"Census Tract 4207.01, Baltimore County, Maryland",3209,436,378,189,287,58,1058,876,365,577,182,936,683,445,331,253,182,166,166,39,16,597,573,509,182,24
1400000US24005420702,"Census Tract 4207.02, Baltimore County, Maryland",2014,404,387,136,374,17,498,463,216,318,35,214,193,189,43,21,309,309,213,103,0,589,580,492,130,9
1400000US24005420800,"Census Tract 4208, Baltimore County, Maryland",3220,416,399,112,350,17,721,645,303,419,76,661,611,453,272,50,490,483,346,209,7,932,817,756,180,115
1400000US24005420900,"Census Tract 4209, Baltimore County, Maryland",3570,720,662,106,652,58,1124,1065,814,418,59,356,356,276,141,0,423,401,194,219,22,947,909,876,87,38
1400000US24005421000,"Census Tract 4210, Baltimore County, Maryland",1664,541,528,126,516,13,356,340,168,246,16,359,328,287,86,31,217,187,162,49,30,191,179,128,78,12
1400000US24005421101,"Census Tract 4211.01, Baltimore County, Maryland",3010,687,616,193,496,71,818,706,270,513,112,413,413,195,296,0,490,490,412,160,0,602,557,497,76,45
1400000US24005421102,"Census Tract 4211.02, Baltimore County, Maryland",2392,404,382,119,346,22,504,499,251,283,5,443,407,284,217,36,493,484,366,190,9,548,518,478,96,30
1400000US24005421200,"Census Tract 4212, Baltimore County, Maryland",1619,315,261,128,175,54,260,229,149,177,31,429,416,338,119,13,227,227,219,56,0,388,380,373,38,8
1400000US24005421300,"Census Tract 4213, Baltimore County, Maryland",2933,659,614,112,560,45,1114,1020,627,490,94,678,582,450,163,96,113,106,85,41,7,369,326,293,69,43
1400000US24005430101,"Census Tract 4301.01, Baltimore County, Maryland",4726,890,673,152,603,217,1673,1340,516,979,333,1470,1140,853,368,330,373,240,191,64,133,320,292,260,60,28
1400000US24005430104,"Census Tract 4301.04, Baltimore County, Maryland",2839,197,138,17,130,59,515,456,268,254,59,423,423,305,152,0,587,578,513,110,9,1117,1084,960,284,33
1400000US24005430200,"Census Tract 4302, Baltimore County, Maryland",2646,654,499,73,499,155,469,469,317,232,0,401,401,280,193,0,511,487,425,90,24,611,600,513,186,11
1400000US24005430300,"Census Tract 4303, Baltimore County, Maryland",5668,1844,1797,458,1574,47,1470,1254,538,826,216,1160,1019,643,565,141,791,779,574,303,12,403,378,297,116,25
1400000US24005430400,"Census Tract 4304, Baltimore County, Maryland",4334,318,283,116,251,35,538,497,326,304,41,871,844,765,149,27,863,863,741,231,0,1744,1707,1629,97,37
1400000US24005430600,"Census Tract 4306, Baltimore County, Maryland",2267,72,72,59,53,0,134,105,84,75,29,325,295,258,136,30,404,395,364,78,9,1332,1301,1255,173,31
1400000US24005430700,"Census Tract 4307, Baltimore County, Maryland",5283,246,233,120,205,13,669,629,292,508,40,762,717,633,164,45,1294,1155,1028,238,139,2312,2096,2057,309,216
1400000US24005430800,"Census Tract 4308, Baltimore County, Maryland",3484,347,347,187,233,0,602,526,316,313,76,717,653,587,109,64,478,456,414,97,22,1340,1281,1255,172,59
1400000US24005430900,"Census Tract 4309, Baltimore County, Maryland",5632,1117,1028,209,831,89,1341,1249,650,750,92,1498,1334,980,479,164,553,519,480,119,34,1123,1105,1048,175,18
1400000US24005440100,"Census Tract 4401, Baltimore County, Maryland",4671,488,434,302,337,54,599,579,388,335,20,752,706,597,186,46,920,857,767,157,63,1912,1859,1726,246,53
1400000US24005440200,"Census Tract 4402, Baltimore County, Maryland",2402,213,213,111,198,0,361,306,165,263,55,663,641,470,237,22,293,293,261,64,0,872,872,847,72,0
1400000US24005440300,"Census Tract 4403, Baltimore County, Maryland",2015,223,205,43,178,18,470,447,321,166,23,447,405,332,120,42,324,319,301,28,5,551,536,536,4,15
1400000US24005440400,"Census Tract 4404, Baltimore County, Maryland",4956,284,284,163,170,0,746,720,446,411,26,904,886,654,330,18,815,762,715,191,53,2207,2079,1812,459,128
1400000US24005440500,"Census Tract 4405, Baltimore County, Maryland",3227,219,209,106,159,10,580,564,425,364,16,401,390,363,134,11,345,305,287,51,40,1682,1519,1398,180,163
1400000US24005440600,"Census Tract 4406, Baltimore County, Maryland",2300,37,37,23,37,0,338,328,168,235,10,224,213,185,132,11,247,247,242,37,0,1454,1406,1381,85,48
1400000US24005440701,"Census Tract 4407.01, Baltimore County, Maryland",6608,360,322,173,233,38,1094,861,691,192,233,2225,1654,1197,595,571,1518,1023,759,375,495,1411,1379,1135,346,32
1400000US24005440702,"Census Tract 4407.02, Baltimore County, Maryland",4826,523,523,218,391,0,681,583,460,270,98,1402,950,626,436,452,671,642,642,12,29,1549,1549,1381,258,0
1400000US24005440800,"Census Tract 4408, Baltimore County, Maryland",3173,323,311,206,180,12,383,383,253,208,0,492,481,430,119,11,377,377,298,157,0,1598,1484,1328,260,114
1400000US24005440900,"Census Tract 4409, Baltimore County, Maryland",3737,234,234,139,105,0,801,591,255,399,210,634,556,305,298,78,816,791,668,236,25,1252,1225,1169,140,27
1400000US24005441000,"Census Tract 4410, Baltimore County, Maryland",3742,285,285,98,195,0,812,812,385,526,0,1078,1050,729,471,28,482,466,358,135,16,1085,1054,804,287,31
1400000US24005441101,"Census Tract 4411.01, Baltimore County, Maryland",2113,218,195,110,147,23,430,388,262,239,42,270,264,202,121,6,318,318,264,145,0,877,856,784,288,21
1400000US24005441102,"Census Tract 4411.02, Baltimore County, Maryland",4980,505,393,213,296,112,1185,1059,462,795,126,1056,975,552,572,81,742,655,555,144,87,1492,1445,1323,282,47
1400000US24005450100,"Census Tract 4501, Baltimore County, Maryland",3814,437,381,199,338,56,872,789,496,406,83,658,648,488,225,10,150,150,150,21,0,1697,1644,1437,368,53
1400000US24005450200,"Census Tract 4502, Baltimore County, Maryland",3167,222,222,98,205,0,555,437,270,299,118,694,679,489,432,15,930,863,792,186,67,766,738,652,108,28
1400000US24005450300,"Census Tract 4503, Baltimore County, Maryland",3151,554,504,147,452,50,595,576,401,364,19,580,528,385,224,52,331,287,258,45,44,1091,1047,938,176,44
1400000US24005450400,"Census Tract 4504, Baltimore County, Maryland",2214,272,256,71,251,16,327,271,194,137,56,259,242,199,103,17,397,397,351,75,0,959,919,734,241,40
1400000US24005450501,"Census Tract 4505.01, Baltimore County, Maryland",4309,610,558,133,535,52,956,829,444,594,127,1003,908,707,375,95,795,787,512,360,8,945,875,789,228,70
1400000US24005450503,"Census Tract 4505.03, Baltimore County, Maryland",6413,857,774,74,717,83,1287,964,697,520,323,1523,1364,998,433,159,1166,1021,578,499,145,1580,1259,810,526,321
1400000US24005450504,"Census Tract 4505.04, Baltimore County, Maryland",5379,1104,1048,221,880,56,2584,2092,1087,1191,492,1016,866,547,319,150,372,372,317,55,0,303,231,101,130,72
1400000US24005450800,"Census Tract 4508, Baltimore County, Maryland",3752,797,755,381,577,42,849,666,397,429,183,1057,961,540,534,96,376,338,225,248,38,673,660,516,215,13
1400000US24005450900,"Census Tract 4509, Baltimore County, Maryland",4140,378,378,187,285,0,684,637,373,482,47,690,657,526,266,33,891,655,558,148,236,1497,1439,1247,393,58
1400000US24005451000,"Census Tract 4510, Baltimore County, Maryland",1690,141,141,55,137,0,254,248,121,192,6,260,255,207,87,5,277,243,173,113,34,758,747,664,175,11
1400000US24005451100,"Census Tract 4511, Baltimore County, Maryland",2246,233,223,78,205,10,298,280,205,101,18,324,306,258,123,18,239,239,203,71,0,1152,1105,1004,174,47
1400000US24005451200,"Census Tract 4512, Baltimore County, Maryland",3570,338,338,130,327,0,565,565,337,409,0,585,540,430,255,45,552,540,487,168,12,1530,1508,1330,330,22
1400000US24005451300,"Census Tract 4513, Baltimore County, Maryland",3882,351,306,87,259,45,1171,1042,374,747,129,923,691,429,428,232,907,810,625,274,97,530,496,491,29,34
1400000US24005451401,"Census Tract 4514.01, Baltimore County, Maryland",4003,507,468,32,453,39,527,490,189,330,37,878,866,770,139,12,417,285,158,174,132,1674,1532,1379,187,142
1400000US24005451402,"Census Tract 4514.02, Baltimore County, Maryland",5268,475,442,314,137,33,1234,1066,553,615,168,1731,1296,748,593,435,848,848,826,111,0,980,430,430,13,550
1400000US24005451500,"Census Tract 4515, Baltimore County, Maryland",3745,331,331,92,286,0,837,785,337,650,52,1010,973,645,437,37,522,434,416,46,88,1045,1013,864,176,32
1400000US24005451600,"Census Tract 4516, Baltimore County, Maryland",2033,228,189,88,162,39,453,431,283,296,22,437,425,369,162,12,329,329,303,49,0,586,550,476,105,36
1400000US24005451701,"Census Tract 4517.01, Baltimore County, Maryland",3757,239,239,158,171,0,709,646,463,343,63,301,249,188,152,52,695,682,630,227,13,1813,1784,1638,254,29
1400000US24005451702,"Census Tract 4517.02, Baltimore County, Maryland",1833,86,82,53,71,4,277,250,95,204,27,414,408,307,178,6,201,195,180,58,6,855,799,735,174,56
1400000US24005451801,"Census Tract 4518.01, Baltimore County, Maryland",5742,829,637,195,539,192,1061,903,583,611,158,795,755,639,236,40,908,793,635,202,115,2149,2124,1932,437,25
1400000US24005451802,"Census Tract 4518.02, Baltimore County, Maryland",3891,461,412,227,308,49,778,705,430,416,73,564,525,344,231,39,833,833,481,466,0,1255,1126,1075,291,129
1400000US24005451803,"Census Tract 4518.03, Baltimore County, Maryland",4099,207,173,60,143,34,839,736,432,439,103,662,625,515,201,37,885,860,749,176,25,1506,1488,1452,118,18
1400000US24005451900,"Census Tract 4519, Baltimore County, Maryland",2599,131,125,66,120,6,283,208,126,128,75,655,621,475,294,34,549,535,482,170,14,981,958,857,192,23
1400000US24005452000,"Census Tract 4520, Baltimore County, Maryland",2638,212,204,122,120,8,354,354,304,188,0,499,416,233,305,83,481,472,431,92,9,1092,1092,1007,304,0
1400000US24005452100,"Census Tract 4521, Baltimore County, Maryland",3380,449,442,86,442,7,469,435,140,371,34,401,347,311,156,54,469,452,441,123,17,1592,1510,1392,297,82
1400000US24005452300,"Census Tract 4523, Baltimore County, Maryland",3106,319,310,153,269,9,1033,776,323,561,257,826,746,609,238,80,582,451,248,237,131,346,118,102,16,228
1400000US24005452400,"Census Tract 4524, Baltimore County, Maryland",3405,324,284,183,250,40,619,501,275,413,118,509,479,361,262,30,286,286,269,85,0,1667,1654,1430,334,13
1400000US24005452500,"Census Tract 4525, Baltimore County, Maryland",3684,596,493,168,440,103,637,617,364,411,20,1101,992,732,355,109,496,475,387,145,21,854,831,756,128,23
1400000US24005490100,"Census Tract 4901, Baltimore County, Maryland",3877,65,65,54,51,0,339,314,219,149,25,251,251,190,172,0,435,424,400,118,11,2787,2736,2581,514,51
1400000US24005490200,"Census Tract 4902, Baltimore County, Maryland",2888,91,91,91,52,0,210,210,164,150,0,333,290,257,51,43,189,174,139,85,15,2065,2039,1978,262,26
1400000US24005490301,"Census Tract 4903.01, Baltimore County, Maryland",5817,1184,1122,828,373,62,1141,991,855,346,150,1205,1152,1068,219,53,645,582,568,100,63,1642,1529,1517,197,113
1400000US24005490302,"Census Tract 4903.02, Baltimore County, Maryland",2683,258,207,137,130,51,305,305,170,272,0,315,315,199,195,0,495,480,391,190,15,1310,1282,1171,326,28
1400000US24005490400,"Census Tract 4904, Baltimore County, Maryland",1738,49,49,25,36,0,82,82,56,59,0,72,72,60,47,0,163,163,136,50,0,1372,1351,1253,291,21
1400000US24005490500,"Census Tract 4905, Baltimore County, Maryland",3672,44,44,27,35,0,206,206,157,124,0,324,317,261,200,7,297,297,228,158,0,2801,2768,2638,370,33
1400000US24005490601,"Census Tract 4906.01, Baltimore County, Maryland",2177,59,59,20,53,0,88,88,70,48,0,367,328,309,71,39,253,253,201,85,0,1410,1403,1396,122,7
1400000US24005490602,"Census Tract 4906.02, Baltimore County, Maryland",2831,290,251,215,43,39,141,115,107,28,26,589,583,552,86,6,365,365,365,47,0,1446,1394,1368,91,52
1400000US24005490603,"Census Tract 4906.03, Baltimore County, Maryland",2084,143,137,89,80,6,128,128,101,52,0,124,124,124,28,0,269,269,265,52,0,1420,1397,1323,224,23
1400000US24005490605,"Census Tract 4906.05, Baltimore County, Maryland",453,341,324,316,17,17,99,99,99,0,0,13,13,13,0,0,0,0,0,0,0,0,0,0,0,0
1400000US24005490701,"Census Tract 4907.01, Baltimore County, Maryland",1338,87,87,58,87,0,112,112,83,95,0,185,177,156,122,8,118,118,106,46,0,836,836,795,243,0
1400000US24005490703,"Census Tract 4907.03, Baltimore County, Maryland",3346,297,266,204,74,31,394,382,263,245,12,294,294,277,39,0,276,268,258,53,8,2085,2005,1890,350,80
1400000US24005490800,"Census Tract 4908, Baltimore County, Maryland",3510,571,538,477,109,33,317,294,262,119,23,302,302,265,57,0,460,446,432,108,14,1860,1846,1781,269,14
1400000US24005490900,"Census Tract 4909, Baltimore County, Maryland",4219,952,952,676,503,0,714,702,520,492,12,367,367,332,108,0,453,453,437,69,0,1733,1709,1541,352,24
1400000US24005491000,"Census Tract 4910, Baltimore County, Maryland",2189,87,87,11,82,0,114,114,83,54,0,226,226,164,113,0,111,111,97,46,0,1651,1614,1591,97,37
1400000US24005491100,"Census Tract 4911, Baltimore County, Maryland",4104,332,268,126,237,64,1046,912,432,638,134,332,322,299,102,10,369,369,288,116,0,2025,2015,1976,62,10
1400000US24005491201,"Census Tract 4912.01, Baltimore County, Maryland",1560,152,120,80,67,32,205,192,136,102,13,172,148,138,44,24,188,183,172,42,5,843,839,816,129,4
1400000US24005491202,"Census Tract 4912.02, Baltimore County, Maryland",1879,206,206,55,191,0,283,222,179,141,61,291,230,230,7,61,517,502,481,45,15,582,564,550,76,18
1400000US24005491300,"Census Tract 4913, Baltimore County, Maryland",3625,971,877,744,144,94,422,373,323,153,49,629,428,339,164,201,450,450,434,68,0,1153,1092,1060,90,61
1400000US24005491401,"Census Tract 4914.01, Baltimore County, Maryland",5695,990,779,405,452,211,2055,1891,1361,631,164,671,610,522,155,61,622,566,506,142,56,1357,1321,1227,166,36
1400000US24005491402,"Census Tract 4914.02, Baltimore County, Maryland",2808,523,476,187,345,47,614,544,439,255,70,315,299,226,139,16,388,388,363,31,0,968,950,796,205,18
1400000US24005491500,"Census Tract 4915, Baltimore County, Maryland",3900,655,551,316,308,104,691,597,339,433,94,601,601,533,97,0,539,445,445,37,94,1414,1337,1292,142,77
1400000US24005491600,"Census Tract 4916, Baltimore County, Maryland",3137,445,417,120,354,28,592,549,337,317,43,976,913,651,300,63,317,273,226,63,44,807,777,740,76,30
1400000US24005491701,"Census Tract 4917.01, Baltimore County, Maryland",4055,331,267,137,208,64,599,566,410,316,33,779,614,479,253,165,1020,1006,926,283,14,1326,1260,1170,121,66
1400000US24005491900,"Census Tract 4919, Baltimore County, Maryland",1867,242,207,85,181,35,297,237,127,203,60,450,403,341,126,47,284,267,190,121,17,594,594,494,224,0
1400000US24005492001,"Census Tract 4920.01, Baltimore County, Maryland",1443,95,79,13,70,16,407,360,224,173,47,455,410,395,62,45,97,79,74,13,18,389,287,271,41,102
1400000US24005492002,"Census Tract 4920.02, Baltimore County, Maryland",3963,445,405,154,337,40,545,472,327,327,73,647,620,559,161,27,745,733,689,177,12,1581,1487,1441,107,94
1400000US24005492101,"Census Tract 4921.01, Baltimore County, Maryland",3696,204,196,133,134,8,605,469,396,229,136,1028,971,818,345,57,812,775,555,332,37,1047,1033,968,107,14
1400000US24005492102,"Census Tract 4921.02, Baltimore County, Maryland",2070,113,100,70,63,13,253,231,139,177,22,388,364,279,137,24,414,326,213,143,88,902,861,810,82,41
1400000US24005492200,"Census Tract 4922, Baltimore County, Maryland",5023,440,440,382,150,0,881,742,404,465,139,1276,1266,1058,243,10,680,680,467,261,0,1746,1719,1676,194,27
1400000US24005492300,"Census Tract 4923, Baltimore County, Maryland",4202,413,391,142,319,22,787,732,244,532,55,616,516,356,237,100,579,524,328,229,55,1807,1655,1279,563,152
1400000US24005492401,"Census Tract 4924.01, Baltimore County, Maryland",3703,116,76,47,40,40,419,409,292,194,10,756,704,558,203,52,760,708,608,170,52,1652,1612,1509,237,40
1400000US24005492402,"Census Tract 4924.02, Baltimore County, Maryland",6657,648,629,434,293,19,746,540,338,235,206,1356,1205,1018,298,151,1106,1106,1079,99,0,2801,2637,2615,171,164
1400000US24005492500,"Census Tract 4925, Baltimore County, Maryland",107,0,0,0,0,0,62,46,46,0,16,0,0,0,0,0,32,32,32,0,0,13,13,13,0,0
1400000US24005492600,"Census Tract 4926, Baltimore County, Maryland",3610,190,161,60,110,29,1079,1060,567,607,19,705,705,694,121,0,212,188,188,8,24,1424,1398,1360,199,26
1400000US24005980000,"Census Tract 9800, Baltimore County, Maryland",0,0,0,0,0,0,0,0,0,0,0,0,0,0,0,0,0,0,0,0,0,0,0,0,0,0
1400000US24005980100,"Census Tract 9801, Baltimore County, Maryland",0,0,0,0,0,0,0,0,0,0,0,0,0,0,0,0,0,0,0,0,0,0,0,0,0,0
1400000US24005980200,"Census Tract 9802, Baltimore County, Maryland",0,0,0,0,0,0,0,0,0,0,0,0,0,0,0,0,0,0,0,0,0,0,0,0,0,0
1400000US24009860101,"Census Tract 8601.01, Calvert County, Maryland",3122,181,181,42,155,0,149,102,80,67,47,344,334,271,155,10,367,313,275,120,54,2081,1891,1841,200,190
1400000US24009860102,"Census Tract 8601.02, Calvert County, Maryland",2692,62,54,21,42,8,274,274,228,148,0,425,399,365,127,26,513,513,466,184,0,1418,1372,1219,293,46
1400000US24009860200,"Census Tract 8602, Calvert County, Maryland",5957,131,65,49,31,66,346,346,218,227,0,638,625,625,180,13,444,430,400,121,14,4398,4346,4094,728,52
1400000US24009860300,"Census Tract 8603, Calvert County, Maryland",4808,235,235,72,207,0,231,203,178,107,28,431,431,297,259,0,582,582,494,179,0,3329,3329,3067,649,0
1400000US24009860401,"Census Tract 8604.01, Calvert County, Maryland",10034,632,558,208,441,74,1274,1094,802,485,180,1060,1007,900,305,53,1209,1209,1062,191,0,5859,5761,5380,849,98
1400000US24009860402,"Census Tract 8604.02, Calvert County, Maryland",3704,230,82,82,15,148,416,403,287,158,13,650,608,355,316,42,401,394,345,65,7,2007,1953,1770,352,54
1400000US24009860501,"Census Tract 8605.01, Calvert County, Maryland",6355,96,96,57,63,0,658,575,289,386,83,541,529,449,122,12,755,621,512,255,134,4305,4209,4153,251,96
1400000US24009860502,"Census Tract 8605.02, Calvert County, Maryland",3129,337,281,171,183,56,131,107,76,78,24,480,448,412,139,32,273,261,261,113,12,1908,1862,1789,292,46
1400000US24009860600,"Census Tract 8606, Calvert County, Maryland",7256,83,83,0,83,0,289,289,249,85,0,810,535,475,366,275,707,671,653,151,36,5367,5230,4646,1105,137
1400000US24009860701,"Census Tract 8607.01, Calvert County, Maryland",2908,298,222,198,215,76,275,265,171,164,10,187,161,138,62,26,283,283,213,143,0,1865,1768,1684,261,97
1400000US24009860702,"Census Tract 8607.02, Calvert County, Maryland",3109,437,388,117,378,49,571,525,309,287,46,417,360,271,167,57,372,347,293,99,25,1312,1281,1202,196,31
1400000US24009860703,"Census Tract 8607.03, Calvert County, Maryland",3785,236,225,123,140,11,538,491,276,339,47,483,444,390,117,39,269,209,201,78,60,2259,2221,1976,461,38
1400000US24009860801,"Census Tract 8608.01, Calvert County, Maryland",7090,336,186,117,126,150,614,540,493,194,74,423,405,287,194,18,1042,1042,827,351,0,4675,4617,4421,846,58
1400000US24009860802,"Census Tract 8608.02, Calvert County, Maryland",4916,398,339,76,333,59,579,519,404,257,60,726,688,535,266,38,588,575,511,101,13,2625,2559,2425,360,66
1400000US24009860900,"Census Tract 8609, Calvert County, Maryland",6965,149,149,149,115,0,1292,1077,651,682,215,839,776,664,343,63,1551,1399,1176,549,152,3134,3070,2949,667,64
1400000US24009861001,"Census Tract 8610.01, Calvert County, Maryland",1082,19,19,4,19,0,72,72,58,50,0,63,63,55,8,0,164,164,164,32,0,764,743,692,162,21
1400000US24009861003,"Census Tract 8610.03, Calvert County, Maryland",5771,553,474,29,474,79,407,387,159,332,20,1195,1007,835,455,188,1306,1281,887,489,25,2310,2278,2058,427,32
1400000US24009861004,"Census Tract 8610.04, Calvert County, Maryland",6833,183,109,109,27,74,912,912,370,581,0,1123,795,642,334,328,1516,1479,1345,214,37,3099,3015,2633,560,84
1400000US24009990100,"Census Tract 9901, Calvert County, Maryland",0,0,0,0,0,0,0,0,0,0,0,0,0,0,0,0,0,0,0,0,0,0,0,0,0,0
1400000US24011955000,"Census Tract 9550, Caroline County, Maryland",3452,967,610,126,525,357,708,591,314,405,117,625,548,377,332,77,615,589,505,111,26,537,452,408,115,85
1400000US24011955100,"Census Tract 9551, Caroline County, Maryland",5417,1066,923,230,820,143,1110,1070,670,679,40,1173,1151,805,444,22,799,759,549,233,40,1269,1172,1080,234,97
1400000US24011955201,"Census Tract 9552.01, Caroline County, Maryland",3648,653,613,252,433,40,896,824,492,425,72,573,509,262,356,64,470,412,328,118,58,1056,1008,938,177,48
1400000US24011955202,"Census Tract 9552.02, Caroline County, Maryland",2018,232,223,114,185,9,663,618,307,539,45,269,256,223,98,13,236,232,200,74,4,618,596,560,97,22
1400000US24011955301,"Census Tract 9553.01, Caroline County, Maryland",4118,693,693,206,564,0,602,548,337,407,54,800,767,578,260,33,777,692,677,95,85,1246,1176,1099,257,70
1400000US24011955302,"Census Tract 9553.02, Caroline County, Maryland",2950,672,613,73,595,59,846,688,380,338,158,608,576,435,249,32,213,213,196,31,0,611,594,562,101,17
1400000US24011955400,"Census Tract 9554, Caroline County, Maryland",2001,179,177,87,158,2,446,432,303,251,14,469,333,225,159,136,300,259,259,19,41,607,597,541,172,10
1400000US24011955500,"Census Tract 9555, Caroline County, Maryland",4343,310,310,105,266,0,935,823,593,337,112,961,878,767,254,83,782,761,567,257,21,1355,1299,1156,338,56
1400000US24011955600,"Census Tract 9556, Caroline County, Maryland",4313,1261,1150,291,1038,111,1045,944,279,798,101,805,704,436,407,101,407,407,283,256,0,795,786,559,305,9
1400000US24013501001,"Census Tract 5010.01, Carroll County, Maryland",4312,591,591,131,559,0,468,461,298,278,7,854,737,506,345,117,784,747,707,60,37,1615,1552,1426,176,63
1400000US24013501002,"Census Tract 5010.02, Carroll County, Maryland",5348,497,440,190,359,57,1003,824,588,398,179,763,654,606,253,109,1183,1138,909,472,45,1902,1869,1680,466,33
1400000US24013502000,"Census Tract 5020, Carroll County, Maryland",3812,205,205,106,176,0,481,414,350,176,67,771,725,609,361,46,448,448,391,129,0,1907,1872,1855,212,35
1400000US24013503000,"Census Tract 5030, Carroll County, Maryland",5433,325,325,145,267,0,905,880,534,650,25,681,681,575,228,0,1267,1257,1183,219,10,2255,2091,1955,368,164
1400000US24013504100,"Census Tract 5041, Carroll County, Maryland",5121,360,334,122,325,26,300,268,174,167,32,764,652,569,191,112,587,566,514,102,21,3110,3058,2890,394,52
1400000US24013504201,"Census Tract 5042.01, Carroll County, Maryland",6190,430,380,173,365,50,270,270,270,219,0,413,384,384,114,29,1162,1098,836,386,64,3915,3859,3820,507,56
1400000US24013504202,"Census Tract 5042.02, Carroll County, Maryland",6335,25,25,25,25,0,472,472,198,378,0,766,608,569,242,158,781,781,675,201,0,4291,4217,3930,735,74
1400000US24013505101,"Census Tract 5051.01, Carroll County, Maryland",4107,141,141,57,102,0,291,281,252,116,10,190,190,190,81,0,512,512,477,80,0,2973,2945,2858,222,28
1400000US24013505102,"Census Tract 5051.02, Carroll County, Maryland",5651,105,97,89,70,8,403,392,281,225,11,576,550,416,288,26,580,580,568,105,0,3987,3898,3750,527,89
1400000US24013505203,"Census Tract 5052.03, Carroll County, Maryland",3070,366,342,257,171,24,127,127,85,96,0,180,180,180,54,0,475,438,248,251,37,1922,1855,1795,188,67
1400000US24013505205,"Census Tract 5052.05, Carroll County, Maryland",3535,103,103,63,67,0,342,329,166,257,13,351,341,306,50,10,664,664,510,254,0,2075,2038,1962,211,37
1400000US24013505206,"Census Tract 5052.06, Carroll County, Maryland",3389,163,163,149,93,0,350,300,246,206,50,431,391,339,230,40,343,343,285,139,0,2102,2102,2083,206,0
1400000US24013505207,"Census Tract 5052.07, Carroll County, Maryland",3885,175,164,116,75,11,293,281,205,151,12,335,326,300,71,9,412,392,373,19,20,2670,2628,2511,264,42
1400000US24013505208,"Census Tract 5052.08, Carroll County, Maryland",4822,143,143,70,143,0,357,357,189,222,0,296,272,257,95,24,534,534,518,125,0,3492,3404,3310,534,88
1400000US24013506101,"Census Tract 5061.01, Carroll County, Maryland",4046,94,94,71,94,0,398,353,298,223,45,444,428,374,146,16,937,929,871,190,8,2173,2134,2099,194,39
1400000US24013506102,"Census Tract 5061.02, Carroll County, Maryland",4043,88,88,54,58,0,476,421,413,254,55,611,602,499,281,9,869,860,775,186,9,1999,1973,1954,146,26
1400000US24013506200,"Census Tract 5062, Carroll County, Maryland",4884,533,533,281,359,0,754,705,589,324,49,750,716,681,186,34,624,624,600,144,0,2223,2204,2063,331,19
1400000US24013507500,"Census Tract 5075, Carroll County, Maryland",3411,378,368,162,273,10,278,216,175,108,62,427,416,329,154,11,515,515,515,119,0,1813,1805,1725,264,8
1400000US24013507601,"Census Tract 5076.01, Carroll County, Maryland",5099,608,608,340,319,0,956,734,315,561,222,773,754,579,314,19,668,668,611,150,0,2094,2057,1890,352,37
1400000US24013507602,"Census Tract 5076.02, Carroll County, Maryland",4005,429,407,149,401,22,648,640,502,356,8,501,422,345,175,79,822,763,701,116,59,1605,1579,1521,154,26
1400000US24013507702,"Census Tract 5077.02, Carroll County, Maryland",3644,352,320,160,287,32,452,447,269,312,5,441,441,342,237,0,682,682,594,181,0,1717,1678,1594,267,39
1400000US24013507703,"Census Tract 5077.03, Carroll County, Maryland",2997,238,212,134,212,26,364,364,334,177,0,404,404,340,256,0,721,677,663,109,44,1270,1250,1191,306,20
1400000US24013507704,"Census Tract 5077.04, Carroll County, Maryland",5986,235,221,74,191,14,527,471,276,240,56,1139,1007,639,432,132,1202,1081,989,130,121,2883,2830,2716,301,53
1400000US24013507801,"Census Tract 5078.01, Carroll County, Maryland",5632,699,678,481,424,21,1447,1396,684,887,51,1122,1003,939,185,119,762,762,762,51,0,1602,1589,1557,123,13
1400000US24013507802,"Census Tract 5078.02, Carroll County, Maryland",4521,259,234,134,188,25,581,555,441,315,26,456,446,437,147,10,840,840,840,168,0,2385,2356,2268,303,29
1400000US24013508101,"Census Tract 5081.01, Carroll County, Maryland",4713,350,350,217,289,0,822,668,466,333,154,422,422,339,165,0,703,685,661,95,18,2416,2410,2279,411,6
1400000US24013508102,"Census Tract 5081.02, Carroll County, Maryland",2903,125,125,53,96,0,348,348,256,219,0,681,649,487,162,32,466,451,416,43,15,1283,1283,1266,131,0
1400000US24013508200,"Census Tract 5082, Carroll County, Maryland",6954,258,211,127,183,47,925,777,537,338,148,993,981,935,199,12,1560,1531,1308,407,29,3218,3189,3051,423,29
1400000US24013509001,"Census Tract 5090.01, Carroll County, Maryland",4157,276,254,179,120,22,272,263,210,130,9,465,465,408,180,0,598,560,507,213,38,2546,2457,2369,279,89
1400000US24013509002,"Census Tract 5090.02, Carroll County, Maryland",2725,124,96,49,77,28,239,206,188,108,33,252,252,216,126,0,363,319,249,99,44,1747,1641,1542,292,106
1400000US24013510000,"Census Tract 5100, Carroll County, Maryland",1411,106,82,26,77,24,157,152,125,91,5,265,234,202,66,31,213,178,168,49,35,670,637,592,119,33
1400000US24013511000,"Census Tract 5110, Carroll County, Maryland",3712,237,226,108,187,11,442,436,207,307,6,621,588,527,149,33,769,769,662,260,0,1643,1623,1571,230,20
1400000US24013512000,"Census Tract 5120, Carroll County, Maryland",1442,214,198,73,164,16,165,146,105,87,19,246,227,197,55,19,352,352,300,84,0,465,446,405,116,19
1400000US24013513001,"Census Tract 5130.01, Carroll County, Maryland",4704,291,291,115,245,0,387,387,292,226,0,384,351,304,173,33,537,405,368,146,132,3105,3032,2924,354,73
1400000US24013513002,"Census Tract 5130.02, Carroll County, Maryland",5414,127,112,50,91,15,132,132,90,86,0,595,529,298,332,66,607,563,512,97,44,3953,3896,3806,280,57
1400000US24013514100,"Census Tract 5141, Carroll County, Maryland",3638,98,98,92,79,0,323,323,285,201,0,361,353,348,85,8,274,264,264,96,10,2582,2539,2454,337,43
1400000US24013514201,"Census Tract 5142.01, Carroll County, Maryland",5040,406,373,233,314,33,816,730,563,371,86,520,499,419,196,21,758,746,729,152,12,2540,2458,2276,456,82
1400000US24013514202,"Census Tract 5142.02, Carroll County, Maryland",3528,141,123,102,75,18,558,548,360,307,10,338,338,305,125,0,328,328,292,88,0,2163,2116,2074,339,47
1400000US24015030100,"Census Tract 301, Cecil County, Maryland",4714,376,340,120,313,36,896,776,599,332,120,1018,998,776,416,20,932,875,689,310,57,1492,1492,1360,358,0
1400000US24015030200,"Census Tract 302, Cecil County, Maryland",4816,469,397,113,354,72,501,442,185,315,59,972,968,811,291,4,1096,997,861,203,99,1778,1755,1718,234,23
1400000US24015030400,"Census Tract 304, Cecil County, Maryland",4677,1903,1409,318,1172,494,936,796,528,519,140,784,695,278,548,89,131,131,131,19,0,923,820,580,350,103
1400000US24015030501,"Census Tract 305.01, Cecil County, Maryland",4182,252,230,120,142,22,811,657,368,376,154,625,592,487,287,33,810,750,605,246,60,1684,1591,1535,150,93
1400000US24015030503,"Census Tract 305.03, Cecil County, Maryland",5090,814,758,264,615,56,785,734,593,343,51,1410,1241,1142,411,169,633,600,522,100,33,1448,1321,1243,172,127
1400000US24015030505,"Census Tract 305.05, Cecil County, Maryland",4014,765,677,246,525,88,547,530,395,346,17,667,594,503,155,73,358,358,328,92,0,1677,1677,1569,153,0
1400000US24015030506,"Census Tract 305.06, Cecil County, Maryland",7934,775,704,191,649,71,1437,1230,677,813,207,1382,1372,1234,342,10,815,758,758,108,57,3525,3364,3165,334,161
1400000US24015030601,"Census Tract 306.01, Cecil County, Maryland",3912,177,169,65,147,8,558,544,321,329,14,675,622,518,263,53,738,708,465,289,30,1764,1753,1580,510,11
1400000US24015030602,"Census Tract 306.02, Cecil County, Maryland",4992,357,340,277,129,17,542,542,272,312,0,1164,1127,853,398,37,567,555,472,130,12,2362,2263,2124,324,99
1400000US24015030700,"Census Tract 307, Cecil County, Maryland",5041,139,131,102,93,8,693,531,305,366,162,896,883,722,310,13,755,755,630,192,0,2558,2537,2264,484,21
1400000US24015030903,"Census Tract 309.03, Cecil County, Maryland",5817,926,867,137,742,59,1431,1231,467,1003,200,700,685,621,197,15,1133,1083,804,434,50,1627,1601,1312,350,26
1400000US24015030904,"Census Tract 309.04, Cecil County, Maryland",7106,299,285,122,209,14,745,686,420,398,59,858,858,809,353,0,1250,1250,1103,284,0,3954,3954,3765,475,0
1400000US24015030905,"Census Tract 309.05, Cecil County, Maryland",2953,302,291,44,273,11,489,432,197,290,57,170,170,165,21,0,794,775,536,270,19,1198,1158,1044,179,40
1400000US24015030906,"Census Tract 309.06, Cecil County, Maryland",10094,773,737,200,680,36,2730,2501,1440,1227,229,1855,1759,1264,762,96,1396,1396,1253,242,0,3340,3210,2946,461,130
1400000US24015031201,"Census Tract 312.01, Cecil County, Maryland",5902,559,526,168,435,33,830,755,473,435,75,1101,1072,890,313,29,894,797,652,211,97,2518,2443,2270,468,75
1400000US24015031202,"Census Tract 312.02, Cecil County, Maryland",5236,493,474,163,474,19,941,907,738,399,34,689,652,462,318,37,1226,1190,1052,158,36,1887,1809,1679,376,78
1400000US24015031301,"Census Tract 313.01, Cecil County, Maryland",3438,139,128,84,128,11,660,629,299,425,31,429,408,382,81,21,498,483,455,92,15,1712,1640,1550,217,72
1400000US24015031302,"Census Tract 313.02, Cecil County, Maryland",6953,771,614,266,493,157,860,809,583,588,51,1141,1115,1019,325,26,1294,1274,1130,243,20,2887,2872,2789,152,15
1400000US24015031400,"Census Tract 314, Cecil County, Maryland",3998,318,216,97,170,102,834,765,395,512,69,575,523,471,168,52,846,810,699,177,36,1425,1416,1384,280,9
1400000US24017850101,"Census Tract 8501.01, Charles County, Maryland",5838,262,218,126,102,44,265,265,223,193,0,1050,993,890,220,57,1238,1169,898,509,69,3023,2862,2787,349,161
1400000US24017850102,"Census Tract 8501.02, Charles County, Maryland",2378,275,217,148,119,58,560,545,365,348,15,342,332,305,141,10,283,260,237,46,23,918,875,828,165,43
1400000US24017850201,"Census Tract 8502.01, Charles County, Maryland",825,98,98,75,23,0,201,201,201,0,0,232,225,225,21,7,192,192,147,45,0,102,102,102,5,0
1400000US24017850202,"Census Tract 8502.02, Charles County, Maryland",4711,694,654,146,573,40,1104,1015,775,403,89,589,531,448,186,58,607,538,509,129,69,1717,1671,1495,265,46
1400000US24017850300,"Census Tract 8503, Charles County, Maryland",2123,211,191,76,153,20,385,343,143,336,42,352,330,330,43,22,173,167,167,20,6,1002,975,894,188,27
1400000US24017850400,"Census Tract 8504, Charles County, Maryland",3617,334,302,132,210,32,448,404,293,158,44,472,461,291,273,11,938,938,874,158,0,1425,1385,1083,445,40
1400000US24017850500,"Census Tract 8505, Charles County, Maryland",2798,252,216,143,124,36,212,196,156,166,16,426,426,372,142,0,212,186,173,37,26,1696,1685,1639,307,11
1400000US24017850600,"Census Tract 8506, Charles County, Maryland",4906,210,210,150,176,0,308,291,194,148,17,606,597,510,216,9,512,512,466,196,0,3270,3246,3054,524,24
1400000US24017850706,"Census Tract 8507.06, Charles County, Maryland",5144,175,127,110,40,48,122,122,122,17,0,568,555,555,88,13,778,727,546,291,51,3501,3429,3272,504,72
1400000US24017850708,"Census Tract 8507.08, Charles County, Maryland",5313,356,330,71,303,26,347,347,298,118,0,531,492,371,238,39,547,524,497,116,23,3532,3464,3220,555,68
1400000US24017850709,"Census Tract 8507.09, Charles County, Maryland",6754,428,387,339,82,41,668,646,571,116,22,1066,1019,837,256,47,1013,900,710,297,113,3579,3531,3034,881,48
1400000US24017850710,"Census Tract 8507.10, Charles County, Maryland",5524,230,220,172,56,10,404,398,338,116,6,610,598,440,239,12,831,807,797,80,24,3449,3359,3272,456,90
1400000US24017850711,"Census Tract 8507.11, Charles County, Maryland",5069,540,531,186,400,9,467,384,203,280,83,954,954,733,277,0,836,825,755,193,11,2272,2183,2110,288,89
1400000US24017850712,"Census Tract 8507.12, Charles County, Maryland",5960,104,87,87,51,17,225,225,178,100,0,477,468,425,138,9,868,830,735,304,38,4286,4074,3998,359,212
1400000US24017850713,"Census Tract 8507.13, Charles County, Maryland",7721,363,312,268,198,51,681,681,273,502,0,428,416,377,139,12,848,831,831,58,17,5401,5282,5013,891,119
1400000US24017850801,"Census Tract 8508.01, Charles County, Maryland",4819,328,328,132,271,0,105,78,70,62,27,836,827,659,331,9,664,664,655,173,0,2886,2815,2607,623,71
1400000US24017850802,"Census Tract 8508.02, Charles County, Maryland",4640,397,231,139,151,166,614,603,446,231,11,1140,1024,736,401,116,559,487,369,161,72,1930,1814,1642,429,116
1400000US24017850901,"Census Tract 8509.01, Charles County, Maryland",5305,1102,1102,413,877,0,1433,1322,671,795,111,1042,966,792,195,76,598,598,541,118,0,1130,1111,805,430,19
1400000US24017850902,"Census Tract 8509.02, Charles County, Maryland",5789,180,180,93,115,0,673,599,395,336,74,948,948,747,351,0,1200,1149,765,551,51,2788,2736,2405,785,52
1400000US24017850904,"Census Tract 8509.04, Charles County, Maryland",8518,395,395,256,211,0,481,474,411,179,7,859,819,667,291,40,1205,1176,1066,227,29,5578,5503,5333,762,75
1400000US24017850905,"Census Tract 8509.05, Charles County, Maryland",4285,272,224,133,123,48,342,342,166,205,0,490,468,450,77,22,1137,981,938,133,156,2044,2044,2003,153,0
1400000US24017850906,"Census Tract 8509.06, Charles County, Maryland",4406,812,812,121,743,0,1172,1172,500,732,0,588,511,491,69,77,354,335,335,56,19,1480,1442,1392,154,38
1400000US24017851001,"Census Tract 8510.01, Charles County, Maryland",2957,240,240,209,191,0,580,526,384,251,54,497,486,415,153,11,331,331,222,195,0,1309,1256,1233,220,53
1400000US24017851002,"Census Tract 8510.02, Charles County, Maryland",8762,491,491,188,417,0,1007,836,653,364,171,1516,1327,690,795,189,1194,1173,1047,327,21,4554,4419,4276,587,135
1400000US24017851100,"Census Tract 8511, Charles County, Maryland",2845,118,118,70,92,0,528,466,384,219,62,215,215,215,60,0,345,345,335,85,0,1639,1559,1456,194,80
1400000US24017851200,"Census Tract 8512, Charles County, Maryland",4985,696,662,179,597,34,841,830,406,587,11,420,420,333,169,0,794,774,695,100,20,2234,2085,1922,322,149
1400000US24017851301,"Census Tract 8513.01, Charles County, Maryland",4732,161,149,77,72,12,850,679,573,293,171,285,285,259,122,0,384,376,354,154,8,3052,2977,2767,402,75
1400000US24017851302,"Census Tract 8513.02, Charles County, Maryland",4151,265,234,182,99,31,392,384,263,234,8,507,498,367,279,9,299,299,281,51,0,2688,2647,2364,538,41
1400000US24017851400,"Census Tract 8514, Charles County, Maryland",8746,516,489,207,382,27,308,308,251,243,0,515,515,504,35,0,779,710,691,324,69,6628,6328,6082,981,300
1400000US24017851500,"Census Tract 8515, Charles County, Maryland",8864,474,427,274,203,47,814,798,518,368,16,1587,1536,1320,372,51,1529,1469,1388,289,60,4460,4259,4019,479,201
1400000US24017990000,"Census Tract 9900, Charles County, Maryland",0,0,0,0,0,0,0,0,0,0,0,0,0,0,0,0,0,0,0,0,0,0,0,0,0,0
1400000US24019970100,"Census Tract 9701, Dorchester County, Maryland",2729,265,237,100,162,28,716,703,251,595,13,505,356,220,223,149,339,292,275,118,47,904,871,766,161,33
1400000US24019970200,"Census Tract 9702, Dorchester County, Maryland",5603,976,926,242,857,50,748,707,322,534,41,927,896,574,519,31,1505,1354,1091,552,151,1447,1425,1329,253,22
1400000US24019970300,"Census Tract 9703, Dorchester County, Maryland",4298,335,310,106,290,25,1025,768,415,575,257,916,898,733,336,18,866,842,771,165,24,1156,1139,1056,206,17
1400000US24019970400,"Census Tract 9704, Dorchester County, Maryland",3373,1036,955,303,716,81,545,484,319,237,61,544,544,374,268,0,537,537,501,119,0,711,636,561,220,75
1400000US24019970500,"Census Tract 9705, Dorchester County, Maryland",3796,1625,1616,258,1525,9,1147,1091,521,852,56,283,226,195,87,57,133,133,104,66,0,608,582,441,253,26
1400000US24019970600,"Census Tract 9706, Dorchester County, Maryland",4547,1075,972,184,913,103,1157,1079,515,762,78,854,842,602,354,12,806,713,485,288,93,655,628,516,148,27
1400000US24019970702,"Census Tract 9707.02, Dorchester County, Maryland",3774,568,557,164,539,11,865,865,576,465,0,702,693,587,289,9,541,541,510,97,0,1098,1081,961,428,17
1400000US24019970804,"Census Tract 9708.04, Dorchester County, Maryland",2120,186,165,80,126,21,537,521,292,416,16,345,324,256,163,21,330,320,313,77,10,722,703,632,190,19
1400000US24019970900,"Census Tract 9709, Dorchester County, Maryland",1553,102,94,40,79,8,423,391,235,276,32,513,504,434,138,9,321,289,245,58,32,194,194,167,48,0
1400000US24019990000,"Census Tract 9900, Dorchester County, Maryland",0,0,0,0,0,0,0,0,0,0,0,0,0,0,0,0,0,0,0,0,0,0,0,0,0,0
1400000US24021740200,"Census Tract 7402, Frederick County, Maryland",4651,456,416,298,342,40,561,561,463,324,0,695,557,424,214,138,599,576,549,129,23,2340,2306,2240,216,34
1400000US24021750100,"Census Tract 7501, Frederick County, Maryland",1475,122,105,35,84,17,331,305,230,101,26,301,290,241,88,11,352,304,287,32,48,369,359,348,49,10
1400000US24021750200,"Census Tract 7502, Frederick County, Maryland",1733,200,137,76,87,63,225,183,163,53,42,224,208,180,43,16,365,294,294,46,71,719,642,621,75,77
1400000US24021750300,"Census Tract 7503, Frederick County, Maryland",1568,375,371,63,335,4,419,389,268,184,30,407,268,224,53,139,200,200,183,39,0,167,161,161,6,6
1400000US24021750503,"Census Tract 7505.03, Frederick County, Maryland",7504,531,516,198,356,15,1655,1253,616,767,402,2571,2145,1441,1024,426,957,957,818,197,0,1790,1719,1515,273,71
1400000US24021750504,"Census Tract 7505.04, Frederick County, Maryland",5232,814,688,353,431,126,977,881,632,350,96,1027,784,615,293,243,835,820,727,209,15,1579,1478,1368,143,101
1400000US24021750505,"Census Tract 7505.05, Frederick County, Maryland",7514,670,589,112,546,81,1997,1753,881,1043,244,2673,2355,1507,1026,318,1037,868,674,220,169,1137,1062,1002,99,75
1400000US24021750506,"Census Tract 7505.06, Frederick County, Maryland",4452,172,161,61,127,11,743,608,328,372,135,461,416,373,140,45,782,589,527,158,193,2294,2272,2148,284,22
1400000US24021750600,"Census Tract 7506, Frederick County, Maryland",2011,130,126,87,92,4,272,272,146,222,0,283,283,224,88,0,262,262,262,79,0,1064,1058,999,233,6
1400000US24021750701,"Census Tract 7507.01, Frederick County, Maryland",5498,358,324,201,192,34,906,829,519,521,77,582,566,517,73,16,1155,1013,912,157,142,2497,2413,2313,267,84
1400000US24021750702,"Census Tract 7507.02, Frederick County, Maryland",3879,857,845,305,630,12,893,659,383,412,234,702,537,484,93,165,674,674,615,171,0,753,657,649,67,96
1400000US24021750801,"Census Tract 7508.01, Frederick County, Maryland",2921,352,332,195,198,20,802,676,521,289,126,498,487,425,125,11,481,481,455,55,0,788,788,752,72,0
1400000US24021750802,"Census Tract 7508.02, Frederick County, Maryland",4831,173,161,123,104,12,496,496,217,395,0,787,753,679,398,34,687,687,673,70,0,2688,2626,2527,626,62
1400000US24021750803,"Census Tract 7508.03, Frederick County, Maryland",6105,337,296,112,240,41,505,505,394,319,0,1207,1034,855,271,173,1132,1076,860,225,56,2924,2777,2727,257,147
1400000US24021751001,"Census Tract 7510.01, Frederick County, Maryland",1005,85,85,47,50,0,80,80,18,62,0,122,122,122,22,0,140,132,130,38,8,578,537,525,17,41
1400000US24021751002,"Census Tract 7510.02, Frederick County, Maryland",5392,649,574,215,445,75,902,860,471,563,42,745,692,618,106,53,823,806,782,114,17,2273,2236,2199,163,37
1400000US24021751003,"Census Tract 7510.03, Frederick County, Maryland",5750,929,929,405,697,0,900,779,334,560,121,956,745,566,262,211,1055,852,798,69,203,1910,1791,1732,97,119
1400000US24021751004,"Census Tract 7510.04, Frederick County, Maryland",3987,216,189,124,110,27,575,526,349,237,49,527,393,381,46,134,656,610,601,58,46,2013,1957,1876,370,56
1400000US24021751201,"Census Tract 7512.01, Frederick County, Maryland",4612,179,168,125,100,11,449,449,358,213,0,456,456,411,191,0,614,602,602,152,12,2914,2858,2827,391,56
1400000US24021751202,"Census Tract 7512.02, Frederick County, Maryland",6300,303,274,148,203,29,571,546,462,219,25,1230,1109,968,324,121,752,740,722,84,12,3444,3421,3396,344,23
1400000US24021751203,"Census Tract 7512.03, Frederick County, Maryland",1905,59,45,34,24,14,308,257,149,181,51,167,167,159,62,0,353,353,347,94,0,1018,1006,908,192,12
1400000US24021751301,"Census Tract 7513.01, Frederick County, Maryland",3508,242,242,52,235,0,331,269,210,181,62,501,494,449,198,7,701,650,437,293,51,1733,1733,1679,266,0
1400000US24021751302,"Census Tract 7513.02, Frederick County, Maryland",3497,383,323,192,238,60,237,173,109,145,64,899,854,530,471,45,585,524,472,106,61,1393,1372,1286,240,21
1400000US24021751600,"Census Tract 7516, Frederick County, Maryland",2968,108,108,38,97,0,345,321,280,200,24,512,447,382,194,65,632,629,629,73,3,1371,1303,1121,306,68
1400000US24021751701,"Census Tract 7517.01, Frederick County, Maryland",2383,95,88,52,55,7,179,164,121,108,15,374,343,282,150,31,318,318,264,103,0,1417,1395,1363,193,22
1400000US24021751702,"Census Tract 7517.02, Frederick County, Maryland",3964,395,351,121,308,44,385,343,317,143,42,566,512,452,232,54,228,179,166,85,49,2390,2333,2047,516,57
1400000US24021751801,"Census Tract 7518.01, Frederick County, Maryland",4788,253,244,190,113,9,215,187,150,55,28,529,529,433,184,0,431,431,416,35,0,3360,3310,3241,209,50
1400000US24021751802,"Census Tract 7518.02, Frederick County, Maryland",3546,188,133,113,76,55,230,225,157,151,5,313,304,239,145,9,225,225,180,73,0,2590,2509,2380,435,81
1400000US24021751901,"Census Tract 7519.01, Frederick County, Maryland",4626,190,131,65,112,59,318,275,221,118,43,502,485,456,154,17,612,612,560,167,0,3004,2976,2910,269,28
1400000US24021751902,"Census Tract 7519.02, Frederick County, Maryland",6104,476,394,347,275,82,373,373,322,249,0,687,677,647,42,10,1086,1086,1043,168,0,3482,3468,3411,280,14
1400000US24021751903,"Census Tract 7519.03, Frederick County, Maryland",5909,49,49,49,32,0,301,267,202,143,34,453,394,350,149,59,489,489,446,163,0,4617,4553,4521,308,64
1400000US24021751904,"Census Tract 7519.04, Frederick County, Maryland",3344,167,145,20,139,22,299,299,222,104,0,163,152,120,32,11,642,627,506,155,15,2073,2060,1945,292,13
1400000US24021752001,"Census Tract 7520.01, Frederick County, Maryland",5072,91,91,68,65,0,545,498,346,269,47,496,486,469,39,10,348,336,325,65,12,3592,3550,3361,457,42
1400000US24021752101,"Census Tract 7521.01, Frederick County, Maryland",3188,45,45,45,0,0,197,197,96,148,0,227,227,218,63,0,332,332,318,92,0,2387,2342,2179,330,45
1400000US24021752102,"Census Tract 7521.02, Frederick County, Maryland",4233,106,99,56,75,7,361,347,270,126,14,575,496,361,227,79,657,623,609,143,34,2534,2509,2417,353,25
1400000US24021752201,"Census Tract 7522.01, Frederick County, Maryland",2173,95,91,58,63,4,253,220,103,194,33,161,157,157,73,4,222,203,191,27,19,1442,1418,1312,288,24
1400000US24021752202,"Census Tract 7522.02, Frederick County, Maryland",4118,81,64,55,58,17,115,71,52,19,44,361,346,228,121,15,447,447,432,45,0,3114,3075,2999,219,39
1400000US24021752204,"Census Tract 7522.04, Frederick County, Maryland",7634,235,225,57,193,10,409,409,136,290,0,576,576,557,63,0,565,492,437,87,73,5849,5699,5465,343,150
1400000US24021752301,"Census Tract 7523.01, Frederick County, Maryland",4583,174,165,135,92,9,653,611,263,377,42,901,851,576,317,50,780,748,669,171,32,2075,1963,1950,86,112
1400000US24021752302,"Census Tract 7523.02, Frederick County, Maryland",4035,128,128,83,106,0,269,269,239,140,0,651,564,463,297,87,330,319,319,125,11,2657,2573,2500,285,84
1400000US24021752303,"Census Tract 7523.03, Frederick County, Maryland",3538,102,89,31,74,13,269,234,176,125,35,295,283,266,62,12,403,381,332,101,22,2469,2414,2239,335,55
1400000US24021752501,"Census Tract 7525.01, Frederick County, Maryland",4970,238,228,196,107,10,498,478,425,281,20,464,441,408,97,23,636,626,611,81,10,3134,3100,2976,406,34
1400000US24021752502,"Census Tract 7525.02, Frederick County, Maryland",2559,87,71,44,45,16,266,251,128,163,15,350,336,290,189,14,421,399,375,138,22,1435,1378,1353,111,57
1400000US24021752601,"Census Tract 7526.01, Frederick County, Maryland",4224,175,169,145,81,6,220,190,106,100,30,391,391,345,214,0,365,365,365,50,0,3073,3040,2963,377,33
1400000US24021752602,"Census Tract 7526.02, Frederick County, Maryland",2750,60,60,24,43,0,237,182,126,119,55,426,426,356,175,0,348,343,343,38,5,1679,1605,1454,309,74
1400000US24021752603,"Census Tract 7526.03, Frederick County, Maryland",3787,52,52,15,52,0,409,350,258,198,59,587,587,520,240,0,515,515,467,96,0,2224,2204,2191,157,20
1400000US24021752801,"Census Tract 7528.01, Frederick County, Maryland",2039,130,120,47,110,10,276,257,228,134,19,290,282,212,147,8,335,309,261,69,26,1008,1003,976,116,5
1400000US24021752802,"Census Tract 7528.02, Frederick County, Maryland",3689,173,160,66,145,13,334,298,229,140,36,400,400,364,95,0,745,695,595,136,50,2037,1979,1818,425,58
1400000US24021752900,"Census Tract 7529, Frederick County, Maryland",3061,346,337,156,273,9,255,239,197,180,16,1078,989,700,394,89,259,248,177,81,11,1123,1098,1005,192,25
1400000US24021753001,"Census Tract 7530.01, Frederick County, Maryland",4852,374,309,179,247,65,870,675,514,351,195,579,553,497,171,26,1001,922,892,273,79,2028,1982,1919,329,46
1400000US24021753002,"Census Tract 7530.02, Frederick County, Maryland",2931,456,399,223,232,57,447,436,245,324,11,666,656,608,102,10,562,562,528,134,0,800,790,741,108,10
1400000US24021765100,"Census Tract 7651, Frederick County, Maryland",3571,566,548,217,438,18,549,514,367,260,35,892,702,664,206,190,443,432,365,182,11,1121,1084,1029,114,37
1400000US24021766800,"Census Tract 7668, Frederick County, Maryland",3915,423,416,147,360,7,551,544,305,380,7,888,837,655,283,51,434,434,397,53,0,1619,1578,1546,152,41
1400000US24021767500,"Census Tract 7675, Frederick County, Maryland",2874,241,165,93,126,76,450,450,251,287,0,478,386,291,168,92,552,490,443,160,62,1153,1135,1114,79,18
1400000US24021767600,"Census Tract 7676, Frederick County, Maryland",3033,344,320,196,273,24,389,364,343,167,25,423,396,332,195,27,207,189,182,21,18,1670,1572,1518,237,98
1400000US24021770700,"Census Tract 7707, Frederick County, Maryland",3565,214,195,101,150,19,279,279,162,161,0,386,372,352,139,14,412,363,300,155,49,2274,2216,2135,324,58
1400000US24021772200,"Census Tract 7722, Frederick County, Maryland",1274,285,258,97,186,27,314,297,90,235,17,332,266,246,111,66,147,147,134,24,0,196,196,190,24,0
1400000US24021773500,"Census Tract 7735, Frederick County, Maryland",4417,382,251,99,200,131,721,571,225,422,150,860,860,773,284,0,608,598,589,152,10,1846,1822,1766,316,24
1400000US24021775302,"Census Tract 7753.02, Frederick County, Maryland",4230,306,293,160,188,13,434,419,297,201,15,880,843,722,255,37,387,348,318,64,39,2223,2171,2127,206,52
1400000US24021775400,"Census Tract 7754, Frederick County, Maryland",3729,502,486,101,449,16,569,569,393,295,0,640,605,437,247,35,536,526,484,70,10,1482,1482,1366,344,0
1400000US24021775600,"Census Tract 7756, Frederick County, Maryland",3921,129,96,96,11,33,442,429,419,55,13,215,206,188,109,9,456,408,375,94,48,2679,2664,2611,343,15
1400000US24023000100,"Census Tract 1, Garrett County, Maryland",3910,531,508,168,449,23,1218,1031,360,895,187,813,767,649,238,46,614,579,549,81,35,734,710,698,86,24
1400000US24023000200,"Census Tract 2, Garrett County, Maryland",4020,601,474,137,440,127,1222,1137,760,553,85,664,647,599,176,17,729,729,586,286,0,804,668,617,91,136
1400000US24023000300,"Census Tract 3, Garrett County, Maryland",2542,392,380,249,193,12,597,562,357,357,35,388,365,319,95,23,347,347,310,74,0,818,806,795,110,12
1400000US24023000400,"Census Tract 4, Garrett County, Maryland",2982,455,409,101,401,46,1068,933,502,653,135,979,894,691,378,85,164,164,145,44,0,316,314,263,66,2
1400000US24023000500,"Census Tract 5, Garrett County, Maryland",3951,662,600,156,520,62,960,811,491,462,149,766,733,600,302,33,264,255,231,93,9,1299,1273,1189,292,26
1400000US24023000600,"Census Tract 6, Garrett County, Maryland",5886,1054,998,302,862,56,1308,1213,638,837,95,787,725,647,252,62,1159,1057,969,245,102,1578,1416,1288,208,162
1400000US24023000700,"Census Tract 7, Garrett County, Maryland",5596,881,817,141,771,64,1855,1677,888,1071,178,1304,1202,795,593,102,664,655,567,243,9,892,874,793,131,18
1400000US24025301102,"Census Tract 3011.02, Harford County, Maryland",3681,226,189,109,182,37,121,121,86,68,0,302,295,134,225,7,328,328,328,92,0,2704,2650,2483,418,54
1400000US24025301105,"Census Tract 3011.05, Harford County, Maryland",3756,237,237,64,181,0,240,240,192,111,0,705,667,585,177,38,710,667,543,178,43,1864,1854,1774,171,10
1400000US24025301106,"Census Tract 3011.06, Harford County, Maryland",4058,232,203,159,97,29,395,384,285,183,11,406,406,394,151,0,549,549,549,59,0,2476,2464,2401,212,12
1400000US24025301107,"Census Tract 3011.07, Harford County, Maryland",3191,568,557,276,408,11,487,404,215,267,83,818,796,554,352,22,596,537,521,66,59,722,696,686,49,26
1400000US24025301108,"Census Tract 3011.08, Harford County, Maryland",3293,116,110,73,103,6,42,42,42,26,0,408,315,250,124,93,221,221,202,45,0,2506,2428,2369,281,78
1400000US24025301201,"Census Tract 3012.01, Harford County, Maryland",1985,294,242,154,227,52,224,219,180,110,5,397,383,291,204,14,379,373,344,75,6,691,666,653,69,25
1400000US24025301202,"Census Tract 3012.02, Harford County, Maryland",7130,631,584,95,540,47,701,561,355,365,140,845,803,691,264,42,1123,1007,994,84,116,3830,3817,3621,419,13
1400000US24025301204,"Census Tract 3012.04, Harford County, Maryland",4000,251,229,24,216,22,337,337,191,190,0,739,723,645,134,16,744,723,675,93,21,1929,1922,1871,162,7
1400000US24025301205,"Census Tract 3012.05, Harford County, Maryland",4218,180,180,159,128,0,620,479,390,188,141,753,740,641,254,13,968,825,772,105,143,1697,1660,1613,109,37
1400000US24025301301,"Census Tract 3013.01, Harford County, Maryland",4571,731,663,181,608,68,413,391,238,264,22,739,695,559,333,44,718,690,648,207,28,1970,1938,1778,264,32
1400000US24025301302,"Census Tract 3013.02, Harford County, Maryland",6461,1299,1299,369,1133,0,1580,1496,914,720,84,926,897,670,316,29,598,585,557,112,13,2058,1950,1613,683,108
1400000US24025301401,"Census Tract 3014.01, Harford County, Maryland",7325,778,670,418,447,108,897,878,677,354,19,1825,1709,1522,484,116,1293,1273,1102,421,20,2532,2532,2214,530,0
1400000US24025301402,"Census Tract 3014.02, Harford County, Maryland",2693,273,240,52,207,33,347,324,195,188,23,523,515,426,199,8,575,542,511,122,33,975,962,937,101,13
1400000US24025301601,"Census Tract 3016.01, Harford County, Maryland",6881,1440,1346,409,971,94,2065,1799,1155,981,266,1272,1224,948,451,48,782,763,740,205,19,1322,1221,1205,131,101
1400000US24025301602,"Census Tract 3016.02, Harford County, Maryland",8169,419,382,245,187,37,1118,1061,558,723,57,1525,1437,1168,562,88,1180,1129,868,409,51,3927,3565,3308,953,362
1400000US24025301702,"Census Tract 3017.02, Harford County, Maryland",8788,506,439,299,244,67,1263,1233,868,642,30,1602,1602,1419,367,0,1097,1063,1063,97,34,4320,3964,3708,572,356
1400000US24025301703,"Census Tract 3017.03, Harford County, Maryland",4848,249,234,84,199,15,504,479,347,225,25,405,387,326,120,18,662,647,627,132,15,3028,2927,2789,365,101
1400000US24025301704,"Census Tract 3017.04, Harford County, Maryland",3166,298,298,190,165,0,427,420,410,49,7,540,508,381,178,32,681,664,624,157,17,1220,1186,1158,96,34
1400000US24025302100,"Census Tract 3021, Harford County, Maryland",2173,111,101,53,59,10,147,147,112,83,0,266,259,259,115,7,319,312,301,116,7,1330,1322,1281,198,8
1400000US24025302200,"Census Tract 3022, Harford County, Maryland",3061,295,285,139,162,10,434,397,302,225,37,420,404,347,174,16,563,563,538,119,0,1349,1349,1245,345,0
1400000US24025302400,"Census Tract 3024, Harford County, Maryland",3875,640,582,143,535,58,657,610,285,531,47,612,562,247,363,50,418,364,290,140,54,1548,1520,1145,537,28
1400000US24025302801,"Census Tract 3028.01, Harford County, Maryland",3533,452,452,180,373,0,687,615,429,386,72,476,476,332,255,0,536,508,467,198,28,1382,1359,1113,516,23
1400000US24025302802,"Census Tract 3028.02, Harford County, Maryland",5302,909,856,355,679,53,923,849,664,376,74,909,748,642,245,161,1085,826,511,383,259,1476,1391,1240,321,85
1400000US24025302901,"Census Tract 3029.01, Harford County, Maryland",2609,912,831,179,730,81,883,823,301,618,60,322,322,171,170,0,178,178,158,27,0,314,314,229,115,0
1400000US24025302902,"Census Tract 3029.02, Harford County, Maryland",3990,435,416,155,381,19,1169,1055,693,657,114,757,742,645,247,15,675,658,539,191,17,954,954,937,162,0
1400000US24025303101,"Census Tract 3031.01, Harford County, Maryland",5871,213,197,77,120,16,369,347,293,197,22,775,756,547,280,19,1049,1049,968,197,0,3465,3364,3185,394,101
1400000US24025303102,"Census Tract 3031.02, Harford County, Maryland",2793,62,57,24,57,5,123,123,57,104,0,230,225,214,74,5,336,336,309,115,0,2042,2004,1956,317,38
1400000US24025303201,"Census Tract 3032.01, Harford County, Maryland",5686,275,265,162,196,10,294,254,214,135,40,489,459,413,137,30,765,752,640,187,13,3863,3833,3814,282,30
1400000US24025303203,"Census Tract 3032.03, Harford County, Maryland",3450,281,273,209,266,8,399,356,183,318,43,461,461,381,179,0,541,529,500,51,12,1768,1755,1655,248,13
1400000US24025303204,"Census Tract 3032.04, Harford County, Maryland",4455,195,195,113,186,0,455,446,362,296,9,714,698,536,358,16,453,453,453,65,0,2638,2601,2534,234,37
1400000US24025303205,"Census Tract 3032.05, Harford County, Maryland",1632,105,89,18,89,16,111,103,71,80,8,71,71,53,30,0,186,162,156,38,24,1159,1144,1139,107,15
1400000US24025303206,"Census Tract 3032.06, Harford County, Maryland",3464,208,195,104,127,13,228,228,173,122,0,527,497,433,222,30,340,340,316,42,0,2161,2146,2039,190,15
1400000US24025303300,"Census Tract 3033, Harford County, Maryland",6209,72,72,55,17,0,835,701,545,520,134,680,680,595,417,0,1079,1079,1038,264,0,3543,3478,3373,345,65
1400000US24025303400,"Census Tract 3034, Harford County, Maryland",4534,235,226,201,140,9,227,217,197,131,10,499,499,410,233,0,540,523,495,172,17,3033,2974,2846,595,59
1400000US24025303501,"Census Tract 3035.01, Harford County, Maryland",6422,673,546,407,534,127,775,730,539,436,45,577,577,526,229,0,857,847,815,192,10,3540,3525,3469,446,15
1400000US24025303502,"Census Tract 3035.02, Harford County, Maryland",3513,136,120,103,120,16,318,307,248,193,11,589,577,524,102,12,504,484,484,74,20,1966,1942,1890,159,24
1400000US24025303602,"Census Tract 3036.02, Harford County, Maryland",3921,153,145,136,63,8,238,225,116,153,13,333,333,315,189,0,479,472,472,134,7,2718,2483,2447,302,235
1400000US24025303603,"Census Tract 3036.03, Harford County, Maryland",7027,217,201,187,74,16,544,544,259,472,0,874,874,737,333,0,926,926,926,131,0,4466,4450,4360,264,16
1400000US24025303605,"Census Tract 3036.05, Harford County, Maryland",6180,499,461,273,427,38,709,688,621,357,21,1198,1098,874,622,100,1113,1086,826,365,27,2661,2551,2358,500,110
1400000US24025303606,"Census Tract 3036.06, Harford County, Maryland",3205,104,104,32,94,0,248,248,162,112,0,151,136,129,45,15,141,141,133,18,0,2561,2511,2431,242,50
1400000US24025303700,"Census Tract 3037, Harford County, Maryland",3822,248,248,74,240,0,353,343,245,227,10,384,348,309,175,36,563,553,530,114,10,2274,2149,1968,415,125
1400000US24025303801,"Census Tract 3038.01, Harford County, Maryland",2503,325,297,128,251,28,374,365,270,174,9,323,323,279,94,0,512,512,512,141,0,969,960,960,115,9
1400000US24025303802,"Census Tract 3038.02, Harford County, Maryland",1675,114,97,49,81,17,205,205,177,114,0,322,245,225,77,77,284,284,270,14,0,750,722,684,108,28
1400000US24025303803,"Census Tract 3038.03, Harford County, Maryland",4891,238,218,125,218,20,712,696,630,325,16,1069,1027,1010,246,42,767,767,751,90,0,2105,2086,1949,357,19
1400000US24025303900,"Census Tract 3039, Harford County, Maryland",2320,55,55,49,36,0,400,370,348,140,30,344,344,325,76,0,352,352,335,63,0,1169,1169,1126,143,0
1400000US24025304101,"Census Tract 3041.01, Harford County, Maryland",4252,228,221,131,167,7,359,328,270,197,31,564,506,465,220,58,681,673,610,118,8,2420,2376,2251,367,44
1400000US24025304102,"Census Tract 3041.02, Harford County, Maryland",3969,159,147,69,98,12,313,256,169,155,57,493,448,385,217,45,724,724,718,81,0,2280,2267,2199,243,13
1400000US24025304201,"Census Tract 3042.01, Harford County, Maryland",6492,175,175,175,136,0,256,221,221,123,35,497,450,402,222,47,860,790,576,358,70,4704,4658,4467,681,46
1400000US24025304202,"Census Tract 3042.02, Harford County, Maryland",6935,506,385,356,115,121,570,570,425,448,0,987,920,829,267,67,575,575,546,107,0,4297,4265,4102,553,32
1400000US24025305100,"Census Tract 3051, Harford County, Maryland",7515,940,940,480,746,0,591,515,327,301,76,750,750,611,463,0,938,924,924,75,14,4296,4140,3944,619,156
1400000US24025305200,"Census Tract 3052, Harford County, Maryland",2602,430,421,244,252,9,338,338,221,229,0,355,326,255,178,29,582,520,457,239,62,897,865,804,106,32
1400000US24025305300,"Census Tract 3053, Harford County, Maryland",2181,154,123,76,97,31,498,462,221,352,36,254,254,210,133,0,369,348,321,83,21,906,783,730,137,123
1400000US24025306100,"Census Tract 3061, Harford County, Maryland",3873,617,598,166,527,19,771,717,306,505,54,586,492,434,175,94,559,559,544,100,0,1340,1333,1224,289,7
1400000US24025306200,"Census Tract 3062, Harford County, Maryland",2171,399,314,145,218,85,556,509,244,407,47,364,364,333,159,0,305,305,268,71,0,547,524,500,164,23
1400000US24025306300,"Census Tract 3063, Harford County, Maryland",2575,260,232,87,178,28,241,234,173,151,7,275,275,264,107,0,361,361,361,47,0,1438,1424,1266,381,14
1400000US24025306400,"Census Tract 3064, Harford County, Maryland",6062,186,186,86,152,0,944,944,794,324,0,803,773,662,256,30,594,550,531,95,44,3535,3498,3450,510,37
1400000US24025306500,"Census Tract 3065, Harford County, Maryland",2011,72,72,72,0,0,593,593,593,89,0,430,429,368,77,1,229,229,229,0,0,687,676,652,71,11
1400000US24027601103,"Census Tract 6011.03, Howard County, Maryland",6419,128,128,114,100,0,172,172,121,109,0,416,416,319,271,0,1003,855,718,219,148,4700,4435,4182,554,265
1400000US24027601104,"Census Tract 6011.04, Howard County, Maryland",6557,50,50,34,39,0,26,26,26,26,0,307,301,235,152,6,353,353,353,26,0,5821,5769,5683,296,52
1400000US24027601105,"Census Tract 6011.05, Howard County, Maryland",4701,90,90,74,71,0,298,265,141,145,33,469,469,442,61,0,335,328,328,33,7,3509,3458,3434,170,51
1400000US24027601107,"Census Tract 6011.07, Howard County, Maryland",5206,219,213,120,129,6,915,657,253,487,258,707,671,552,195,36,1103,966,745,270,137,2262,2100,2051,191,162
1400000US24027601108,"Census Tract 6011.08, Howard County, Maryland",3780,18,18,8,18,0,198,161,111,65,37,607,596,585,27,11,651,637,594,74,14,2306,2295,2264,180,11
1400000US24027601201,"Census Tract 6012.01, Howard County, Maryland",8181,652,602,353,441,50,529,529,472,153,0,918,903,781,266,15,1085,1085,1001,131,0,4997,4904,4830,356,93
1400000US24027601203,"Census Tract 6012.03, Howard County, Maryland",5076,401,307,49,271,94,524,524,464,104,0,537,532,386,175,5,723,718,698,20,5,2891,2822,2693,341,69
1400000US24027601204,"Census Tract 6012.04, Howard County, Maryland",5742,193,81,15,66,112,1011,738,318,586,273,749,696,557,152,53,1031,989,913,348,42,2758,2529,2475,270,229
1400000US24027602100,"Census Tract 6021, Howard County, Maryland",7657,63,63,63,37,0,411,404,361,191,7,394,394,394,169,0,333,311,294,132,22,6456,6228,5865,757,228
1400000US24027602201,"Census Tract 6022.01, Howard County, Maryland",3465,321,238,160,106,83,147,142,79,92,5,203,203,193,44,0,219,208,191,41,11,2575,2501,2394,303,74
1400000US24027602202,"Census Tract 6022.02, Howard County, Maryland",5426,126,112,42,93,14,299,295,239,134,4,514,486,429,271,28,727,704,670,86,23,3760,3555,3489,284,205
1400000US24027602302,"Census Tract 6023.02, Howard County, Maryland",7808,215,183,55,138,32,1042,980,588,436,62,508,475,398,137,33,745,717,666,147,28,5298,4991,4803,495,307
1400000US24027602303,"Census Tract 6023.03, Howard County, Maryland",3881,20,20,13,20,0,92,85,66,19,7,82,82,82,46,0,244,244,218,53,0,3443,3412,3240,440,31
1400000US24027602304,"Census Tract 6023.04, Howard County, Maryland",5059,184,184,172,70,0,63,63,63,63,0,181,170,136,73,11,298,266,246,91,32,4333,4143,4009,522,190
1400000US24027602305,"Census Tract 6023.05, Howard County, Maryland",3857,100,100,54,63,0,236,236,110,236,0,295,241,180,174,54,153,147,136,55,6,3073,3041,2906,382,32
1400000US24027602306,"Census Tract 6023.06, Howard County, Maryland",5524,330,292,161,245,38,345,345,237,159,0,666,636,375,362,30,810,810,760,261,0,3373,3289,3087,424,84
1400000US24027602600,"Census Tract 6026, Howard County, Maryland",7835,805,768,315,553,37,1399,1234,755,662,165,1538,1327,819,672,211,1218,1194,1062,300,24,2875,2619,2503,336,256
1400000US24027602700,"Census Tract 6027, Howard County, Maryland",5394,139,132,99,72,7,329,316,230,198,13,387,371,312,252,16,332,332,332,159,0,4207,4109,3963,386,98
1400000US24027602800,"Census Tract 6028, Howard County, Maryland",6055,177,177,74,138,0,741,721,184,629,20,523,502,439,111,21,560,560,538,116,0,4054,4013,3806,524,41
1400000US24027602900,"Census Tract 6029, Howard County, Maryland",5091,640,562,268,425,78,629,429,290,190,200,612,600,583,75,12,620,575,575,7,45,2590,2577,2512,266,13
1400000US24027603001,"Census Tract 6030.01, Howard County, Maryland",6069,341,323,186,215,18,345,290,231,265,55,550,498,415,262,52,484,407,393,175,77,4349,4314,4276,564,35
1400000US24027603003,"Census Tract 6030.03, Howard County, Maryland",3888,38,38,30,30,0,89,60,39,52,29,242,223,203,174,19,184,184,177,26,0,3335,3312,3258,415,23
1400000US24027603004,"Census Tract 6030.04, Howard County, Maryland",6668,118,118,85,33,0,249,243,177,176,6,189,189,174,156,0,388,388,388,53,0,5724,5674,5407,867,50
1400000US24027604001,"Census Tract 6040.01, Howard County, Maryland",5890,198,198,41,157,0,121,121,54,91,0,497,479,439,162,18,649,627,599,267,22,4425,4370,4139,700,55
1400000US24027604002,"Census Tract 6040.02, Howard County, Maryland",8099,117,117,36,117,0,391,391,375,200,0,597,555,501,240,42,876,876,858,139,0,6118,6022,5883,706,96
1400000US24027605102,"Census Tract 6051.02, Howard County, Maryland",10854,363,363,320,115,0,249,249,179,126,0,681,681,486,328,0,551,534,416,235,17,9010,8791,8363,1325,219
1400000US24027605103,"Census Tract 6051.03, Howard County, Maryland",5073,48,48,39,48,0,241,241,231,129,0,462,452,452,127,10,237,227,227,83,10,4085,3976,3908,490,109
1400000US24027605104,"Census Tract 6051.04, Howard County, Maryland",5427,25,25,17,16,0,70,70,59,27,0,261,239,220,109,22,322,312,290,82,10,4749,4656,4380,733,93
1400000US24027605401,"Census Tract 6054.01, Howard County, Maryland",4945,332,332,150,246,0,484,426,184,359,58,776,742,691,130,34,924,887,840,114,37,2429,2429,2357,343,0
1400000US24027605402,"Census Tract 6054.02, Howard County, Maryland",6993,1213,1213,345,1108,0,415,384,234,312,31,888,838,713,283,50,1171,1149,1120,289,22,3306,2876,2651,833,430
1400000US24027605502,"Census Tract 6055.02, Howard County, Maryland",5172,386,386,111,275,0,351,253,131,190,98,373,355,329,160,18,603,603,603,83,0,3459,3441,3362,678,18
1400000US24027605503,"Census Tract 6055.03, Howard County, Maryland",6409,1024,949,421,608,75,557,421,245,244,136,436,436,427,106,0,1242,964,918,144,278,3150,3007,2915,424,143
1400000US24027605504,"Census Tract 6055.04, Howard County, Maryland",2620,14,14,0,14,0,51,51,51,7,0,88,88,88,10,0,92,30,30,0,62,2375,2349,2343,185,26
1400000US24027605505,"Census Tract 6055.05, Howard County, Maryland",6270,25,25,9,25,0,42,26,19,26,16,147,147,110,94,0,343,320,314,65,23,5713,5539,5298,501,174
1400000US24027605601,"Census Tract 6056.01, Howard County, Maryland",6600,869,869,279,709,0,673,673,520,202,0,798,746,576,211,52,452,452,427,99,0,3808,3721,3600,705,87
1400000US24027605602,"Census Tract 6056.02, Howard County, Maryland",8112,554,480,368,220,74,511,426,344,242,85,604,547,530,116,57,760,760,730,78,0,5683,5376,5069,998,307
1400000US24027606601,"Census Tract 6066.01, Howard County, Maryland",2983,75,67,33,41,8,107,107,100,66,0,331,331,296,125,0,332,332,332,116,0,2138,2127,1940,495,11
1400000US24027606603,"Census Tract 6066.03, Howard County, Maryland",7401,462,363,167,218,99,980,909,637,448,71,1379,1259,941,463,120,1893,1835,1675,289,58,2687,2687,2466,605,0
1400000US24027606604,"Census Tract 6066.04, Howard County, Maryland",4665,191,157,104,110,34,280,261,178,138,19,937,937,549,432,0,681,656,565,234,25,2576,2522,2229,568,54
1400000US24027606606,"Census Tract 6066.06, Howard County, Maryland",5045,449,403,184,312,46,922,863,333,574,59,678,643,528,143,35,601,583,568,50,18,2395,2266,2033,350,129
1400000US24027606607,"Census Tract 6066.07, Howard County, Maryland",4990,74,64,28,64,10,417,396,144,329,21,756,642,439,285,114,718,718,694,198,0,3025,2742,2468,626,283
1400000US24027606701,"Census Tract 6067.01, Howard County, Maryland",2829,20,20,14,20,0,128,128,64,93,0,349,164,150,76,185,314,302,260,137,12,2018,1977,1922,270,41
1400000US24027606704,"Census Tract 6067.04, Howard County, Maryland",6739,371,356,169,305,15,687,598,400,489,89,1081,1061,716,523,20,501,501,450,90,0,4099,3938,3626,729,161
1400000US24027606705,"Census Tract 6067.05, Howard County, Maryland",1932,78,78,26,78,0,104,93,65,38,11,178,166,139,107,12,180,156,150,37,24,1392,1380,1342,210,12
1400000US24027606706,"Census Tract 6067.06, Howard County, Maryland",4867,305,281,247,133,24,371,365,195,260,6,374,374,341,77,0,340,315,282,165,25,3477,3442,3279,439,35
1400000US24027606707,"Census Tract 6067.07, Howard County, Maryland",3719,892,865,85,817,27,364,337,242,166,27,591,534,436,169,57,309,309,309,43,0,1563,1543,1519,69,20
1400000US24027606803,"Census Tract 6068.03, Howard County, Maryland",5908,452,434,75,376,18,715,646,138,554,69,764,633,595,155,131,1024,958,942,230,66,2953,2953,2860,301,0
1400000US24027606804,"Census Tract 6068.04, Howard County, Maryland",3493,143,131,52,79,12,198,198,145,130,0,266,266,242,41,0,516,516,487,110,0,2370,2357,2219,384,13
1400000US24027606805,"Census Tract 6068.05, Howard County, Maryland",4271,76,76,39,76,0,91,91,40,76,0,384,317,308,60,67,427,408,380,137,19,3293,3194,3117,365,99
1400000US24027606806,"Census Tract 6068.06, Howard County, Maryland",7612,381,316,165,209,65,227,170,129,106,57,497,468,423,92,29,792,752,692,169,40,5715,5549,5220,761,166
1400000US24027606901,"Census Tract 6069.01, Howard County, Maryland",5976,280,233,97,209,47,892,858,550,423,34,909,737,595,188,172,1252,1125,940,222,127,2643,2554,2400,417,89
1400000US24027606904,"Census Tract 6069.04, Howard County, Maryland",4767,137,121,27,105,16,778,575,24,558,203,467,354,319,43,113,889,858,744,268,31,2496,2469,2389,141,27
1400000US24027606905,"Census Tract 6069.05, Howard County, Maryland",6830,407,318,44,285,89,593,471,258,229,122,993,956,846,189,37,731,714,555,173,17,4106,3930,3833,498,176
1400000US24027606906,"Census Tract 6069.06, Howard County, Maryland",6419,303,279,93,204,24,956,735,562,223,221,793,647,514,168,146,1093,1032,947,137,61,3274,2928,2743,344,346
1400000US24027606907,"Census Tract 6069.07, Howard County, Maryland",6419,526,519,198,460,7,1152,910,674,491,242,1562,1359,864,509,203,729,620,550,126,109,2450,1993,1914,109,457
1400000US24029950100,"Census Tract 9501, Kent County, Maryland",3777,451,362,119,315,89,589,483,346,257,106,860,818,605,267,42,504,467,422,94,37,1373,1256,1090,293,117
1400000US24029950200,"Census Tract 9502, Kent County, Maryland",4564,501,442,119,390,59,903,850,419,637,53,923,917,791,282,6,695,595,543,149,100,1542,1493,1378,312,49
1400000US24029950300,"Census Tract 9503, Kent County, Maryland",4125,973,922,245,782,51,779,663,541,369,116,988,947,529,620,41,342,342,342,165,0,1043,1043,1026,383,0
1400000US24029950400,"Census Tract 9504, Kent County, Maryland",3083,206,200,96,142,6,919,903,292,823,16,472,472,334,247,0,686,661,548,254,25,800,775,641,345,25
1400000US24029950500,"Census Tract 9505, Kent County, Maryland",2479,616,578,175,483,38,383,328,166,240,55,484,392,252,250,92,246,246,171,124,0,750,749,717,161,1
1400000US24029990000,"Census Tract 9900, Kent County, Maryland",0,0,0,0,0,0,0,0,0,0,0,0,0,0,0,0,0,0,0,0,0,0,0,0,0,0
1400000US24031700101,"Census Tract 7001.01, Montgomery County, Maryland",4378,92,92,75,51,0,235,184,106,108,51,140,123,120,49,17,272,230,202,60,42,3639,3575,3338,642,64
1400000US24031700103,"Census Tract 7001.03, Montgomery County, Maryland",5239,109,109,76,52,0,314,282,129,241,32,539,539,509,175,0,377,346,273,113,31,3900,3807,3639,495,93
1400000US24031700104,"Census Tract 7001.04, Montgomery County, Maryland",5634,428,388,25,376,40,465,451,356,141,14,1018,989,365,642,29,618,511,485,132,107,3105,2915,2844,326,190
1400000US24031700105,"Census Tract 7001.05, Montgomery County, Maryland",6266,365,327,176,164,38,442,425,217,225,17,827,691,531,249,136,843,825,721,135,18,3789,3664,3392,526,125
1400000US24031700204,"Census Tract 7002.04, Montgomery County, Maryland",1912,132,127,49,115,5,96,96,63,62,0,326,321,281,163,5,428,349,292,112,79,930,930,870,174,0
1400000US24031700205,"Census Tract 7002.05, Montgomery County, Maryland",10406,414,398,104,311,16,353,353,285,94,0,969,841,562,350,128,1004,955,914,198,49,7666,7518,7438,688,148
1400000US24031700206,"Census Tract 7002.06, Montgomery County, Maryland",5547,126,126,112,81,0,165,132,80,78,33,570,553,490,152,17,611,592,555,127,19,4075,3979,3703,590,96
1400000US24031700207,"Census Tract 7002.07, Montgomery County, Maryland",5680,536,488,126,421,48,610,593,398,221,17,651,604,429,218,47,592,584,552,72,8,3291,3187,3043,344,104
1400000US24031700208,"Census Tract 7002.08, Montgomery County, Maryland",2368,98,93,74,56,5,105,79,37,49,26,221,221,179,91,0,248,236,233,20,12,1696,1682,1617,187,14
1400000US24031700304,"Census Tract 7003.04, Montgomery County, Maryland",8499,526,486,199,287,40,688,606,307,367,82,684,684,559,173,0,659,634,565,110,25,5942,5766,5706,411,176
1400000US24031700306,"Census Tract 7003.06, Montgomery County, Maryland",7333,176,96,32,64,80,1073,991,824,167,82,631,575,491,84,56,927,851,764,127,76,4526,4401,4311,350,125
1400000US24031700308,"Census Tract 7003.08, Montgomery County, Maryland",6023,223,161,41,161,62,737,679,405,344,58,930,896,588,341,34,913,773,754,19,140,3220,3105,2955,387,115
1400000US24031700309,"Census Tract 7003.09, Montgomery County, Maryland",5774,461,350,198,172,111,1083,1069,581,553,14,1252,1198,1047,192,54,860,860,860,97,0,2118,2087,2000,269,31
1400000US24031700310,"Census Tract 7003.10, Montgomery County, Maryland",6482,668,621,136,512,47,548,517,500,17,31,1716,1455,1221,318,261,911,807,752,55,104,2639,2639,2467,220,0
1400000US24031700311,"Census Tract 7003.11, Montgomery County, Maryland",9975,268,234,106,175,34,679,622,385,301,57,679,679,670,30,0,1124,1048,1048,12,76,7225,6913,6280,916,312
1400000US24031700312,"Census Tract 7003.12, Montgomery County, Maryland",5834,134,88,77,44,46,382,382,130,318,0,494,415,399,77,79,990,944,891,53,46,3834,3673,3560,547,161
1400000US24031700400,"Census Tract 7004, Montgomery County, Maryland",2063,106,97,87,51,9,215,192,152,86,23,153,148,135,53,5,255,231,159,98,24,1334,1287,1229,217,47
1400000US24031700500,"Census Tract 7005, Montgomery County, Maryland",6749,191,176,126,137,15,365,253,152,158,112,547,547,481,153,0,337,337,337,37,0,5309,5228,5017,654,81
1400000US24031700604,"Census Tract 7006.04, Montgomery County, Maryland",6464,0,0,0,0,0,224,224,196,92,0,405,396,372,179,9,270,239,136,146,31,5565,5552,5392,583,13
1400000US24031700606,"Census Tract 7006.06, Montgomery County, Maryland",4194,114,114,83,59,0,174,174,135,58,0,283,283,265,95,0,333,324,317,61,9,3290,3189,3110,307,101
1400000US24031700607,"Census Tract 7006.07, Montgomery County, Maryland",7821,375,375,157,274,0,531,531,284,332,0,584,531,472,59,53,377,335,335,50,42,5954,5811,5656,456,143
1400000US24031700608,"Census Tract 7006.08, Montgomery County, Maryland",6040,197,180,145,35,17,333,310,194,176,23,160,160,153,42,0,272,214,159,87,58,5078,4969,4462,846,109
1400000US24031700610,"Census Tract 7006.10, Montgomery County, Maryland",2229,44,19,19,11,25,85,85,60,44,0,219,143,67,99,76,200,200,169,78,0,1681,1661,1596,318,20
1400000US24031700611,"Census Tract 7006.11, Montgomery County, Maryland",6356,236,215,56,168,21,102,102,42,78,0,249,218,136,90,31,869,861,816,133,8,4900,4772,4512,501,128
1400000US24031700613,"Census Tract 7006.13, Montgomery County, Maryland",6336,384,283,118,226,101,554,505,209,352,49,732,671,498,216,61,447,431,406,66,16,4219,4182,3999,429,37
1400000US24031700614,"Census Tract 7006.14, Montgomery County, Maryland",5303,599,577,334,312,22,648,581,348,345,67,1152,1031,853,273,121,662,643,621,89,19,2242,2085,1924,223,157
1400000US24031700615,"Census Tract 7006.15, Montgomery County, Maryland",2987,42,42,31,11,0,78,73,61,26,5,260,255,176,113,5,124,124,124,14,0,2483,2464,2327,311,19
1400000US24031700616,"Census Tract 7006.16, Montgomery County, Maryland",4753,32,32,0,32,0,231,207,164,80,24,458,451,389,222,7,247,247,217,85,0,3785,3736,3668,470,49
1400000US24031700704,"Census Tract 7007.04, Montgomery County, Maryland",3236,262,212,60,169,50,593,361,269,130,232,429,300,230,100,129,379,303,226,144,76,1573,1478,1135,468,95
1400000US24031700706,"Census Tract 7007.06, Montgomery County, Maryland",4450,392,361,130,269,31,760,688,412,294,72,754,686,501,202,68,563,488,452,67,75,1981,1935,1874,164,46
1400000US24031700710,"Census Tract 7007.10, Montgomery County, Maryland",6455,206,206,92,206,0,848,487,182,423,361,1174,679,453,285,495,877,766,548,345,111,3350,3242,3009,668,108
1400000US24031700711,"Census Tract 7007.11, Montgomery County, Maryland",6038,275,248,152,130,27,649,564,416,193,85,726,699,444,345,27,961,860,709,238,101,3427,3308,3144,525,119
1400000US24031700713,"Census Tract 7007.13, Montgomery County, Maryland",5862,858,614,182,464,244,1735,1169,506,705,566,1530,1167,801,430,363,542,469,258,256,73,1197,1100,1055,135,97
1400000US24031700715,"Census Tract 7007.15, Montgomery County, Maryland",6399,236,220,29,212,16,728,674,345,398,54,829,829,652,325,0,1115,1002,836,166,113,3491,3181,2920,567,310
1400000US24031700716,"Census Tract 7007.16, Montgomery County, Maryland",8878,1029,845,205,684,184,1234,1005,489,559,229,785,654,616,95,131,1077,1077,973,332,0,4753,4561,4322,527,192
1400000US24031700717,"Census Tract 7007.17, Montgomery County, Maryland",7460,646,565,127,449,81,1532,1205,717,837,327,1866,1318,1022,478,548,1119,920,766,248,199,2297,1887,1777,262,410
1400000US24031700718,"Census Tract 7007.18, Montgomery County, Maryland",5316,221,207,121,164,14,317,273,211,153,44,862,826,695,261,36,713,703,650,147,10,3203,3113,3019,563,90
1400000US24031700719,"Census Tract 7007.19, Montgomery County, Maryland",9682,1189,860,226,733,329,1596,1276,619,803,320,2628,1903,1387,629,725,1423,1136,708,458,287,2846,2469,2158,497,377
1400000US24031700720,"Census Tract 7007.20, Montgomery County, Maryland",3746,220,184,96,101,36,577,485,212,325,92,422,343,175,206,79,642,551,421,278,91,1885,1665,1607,194,220
1400000US24031700721,"Census Tract 7007.21, Montgomery County, Maryland",3275,486,346,18,346,140,757,490,324,220,267,588,465,254,257,123,315,280,259,21,35,1129,883,643,248,246
1400000US24031700722,"Census Tract 7007.22, Montgomery County, Maryland",4625,515,447,89,371,68,978,874,561,330,104,617,514,354,177,103,788,649,537,165,139,1727,1612,1493,311,115
1400000US24031700723,"Census Tract 7007.23, Montgomery County, Maryland",3395,422,397,121,397,25,908,880,417,776,28,627,502,388,347,125,339,339,284,117,0,1099,995,902,616,104
1400000US24031700724,"Census Tract 7007.24, Montgomery County, Maryland",3635,526,373,93,341,153,1470,875,355,520,595,629,458,352,117,171,523,384,319,65,139,487,296,245,51,191
1400000US24031700810,"Census Tract 7008.10, Montgomery County, Maryland",5377,364,358,71,308,6,710,710,342,423,0,822,730,478,324,92,744,723,548,221,21,2737,2534,2456,418,203
1400000US24031700811,"Census Tract 7008.11, Montgomery County, Maryland",4325,149,135,20,123,14,637,567,248,359,70,826,748,559,280,78,772,609,449,246,163,1941,1842,1703,329,99
1400000US24031700812,"Census Tract 7008.12, Montgomery County, Maryland",4096,430,304,124,233,126,495,453,212,342,42,494,440,366,147,54,536,292,282,36,244,2141,2034,1927,254,107
1400000US24031700813,"Census Tract 7008.13, Montgomery County, Maryland",5818,401,340,133,263,61,1237,1153,653,583,84,1077,944,673,335,133,873,862,737,240,11,2230,2058,1883,441,172
1400000US24031700815,"Census Tract 7008.15, Montgomery County, Maryland",7453,874,779,142,687,95,591,542,187,369,49,1334,1151,927,308,183,998,762,381,426,236,3656,3395,2924,728,261
1400000US24031700816,"Census Tract 7008.16, Montgomery County, Maryland",8953,828,777,434,399,51,1352,1074,352,810,278,1271,1098,1002,206,173,2083,1924,1640,320,159,3419,3095,2973,199,324
1400000US24031700817,"Census Tract 7008.17, Montgomery County, Maryland",6192,648,499,230,306,149,710,512,360,229,198,1030,947,803,245,83,550,520,504,38,30,3254,3208,3109,222,46
1400000US24031700818,"Census Tract 7008.18, Montgomery County, Maryland",6737,869,733,216,546,136,1745,1312,471,963,433,1646,1437,534,924,209,841,593,494,144,248,1636,1536,1368,237,100
1400000US24031700819,"Census Tract 7008.19, Montgomery County, Maryland",7088,389,334,103,269,55,1592,1246,815,570,346,813,763,615,209,50,1201,1161,1152,86,40,3093,3043,2799,366,50
1400000US24031700820,"Census Tract 7008.20, Montgomery County, Maryland",2765,309,249,89,173,60,430,328,147,189,102,565,347,276,112,218,439,359,301,66,80,1022,992,896,135,30
1400000US24031700822,"Census Tract 7008.22, Montgomery County, Maryland",1846,150,92,21,71,58,477,296,154,170,181,197,130,124,16,67,436,410,389,28,26,586,560,524,85,26
1400000US24031700823,"Census Tract 7008.23, Montgomery County, Maryland",3433,174,174,96,100,0,273,246,100,176,27,285,254,254,24,31,469,462,417,81,7,2232,2171,2076,307,61
1400000US24031700824,"Census Tract 7008.24, Montgomery County, Maryland",2866,119,119,54,83,0,100,86,65,21,14,215,197,164,100,18,395,395,380,46,0,2037,1934,1785,303,103
1400000US24031700826,"Census Tract 7008.26, Montgomery County, Maryland",5555,256,256,184,126,0,230,230,165,158,0,463,463,387,268,0,558,558,545,127,0,4048,4018,3901,442,30
1400000US24031700828,"Census Tract 7008.28, Montgomery County, Maryland",2221,69,69,22,55,0,115,115,57,69,0,187,182,177,49,5,157,150,150,28,7,1693,1693,1650,152,0
1400000US24031700829,"Census Tract 7008.29, Montgomery County, Maryland",3205,160,155,140,50,5,81,81,71,53,0,425,403,345,139,22,231,231,223,60,0,2308,2243,2224,222,65
1400000US24031700830,"Census Tract 7008.30, Montgomery County, Maryland",3178,390,371,188,232,19,573,490,411,266,83,683,600,556,131,83,521,339,277,70,182,1011,969,883,145,42
1400000US24031700832,"Census Tract 7008.32, Montgomery County, Maryland",3316,344,288,25,276,56,667,486,169,342,181,514,420,367,66,94,730,716,703,62,14,1061,931,768,224,130
1400000US24031700833,"Census Tract 7008.33, Montgomery County, Maryland",4002,113,56,35,51,57,440,347,75,283,93,1047,805,477,392,242,574,487,448,49,87,1828,1708,1521,225,120
1400000US24031700834,"Census Tract 7008.34, Montgomery County, Maryland",5277,560,509,166,375,51,549,461,212,286,88,1095,875,713,228,220,564,441,318,129,123,2509,2427,2164,398,82
1400000US24031700835,"Census Tract 7008.35, Montgomery County, Maryland",4800,91,91,47,84,0,596,551,327,224,45,346,310,227,119,36,346,320,300,71,26,3421,3347,3128,370,74
1400000US24031700901,"Census Tract 7009.01, Montgomery County, Maryland",4459,693,604,344,540,89,432,387,167,287,45,769,623,587,36,146,544,491,456,72,53,2021,1950,1849,280,71
1400000US24031700902,"Census Tract 7009.02, Montgomery County, Maryland",4052,438,404,76,396,34,638,538,186,417,100,754,631,378,320,123,333,285,247,58,48,1889,1695,1629,228,194
1400000US24031700903,"Census Tract 7009.03, Montgomery County, Maryland",2239,66,60,35,25,6,523,393,138,342,130,542,419,201,249,123,320,320,305,38,0,788,781,688,131,7
1400000US24031700904,"Census Tract 7009.04, Montgomery County, Maryland",3021,526,437,213,281,89,906,755,608,177,151,508,314,215,136,194,310,302,282,32,8,771,754,729,25,17
1400000US24031700905,"Census Tract 7009.05, Montgomery County, Maryland",4159,242,242,166,164,0,665,665,487,282,0,805,746,726,50,59,616,616,597,51,0,1831,1823,1760,118,8
1400000US24031701001,"Census Tract 7010.01, Montgomery County, Maryland",5681,294,276,188,143,18,612,576,228,418,36,1009,819,626,321,190,877,844,703,278,33,2889,2833,2781,332,56
1400000US24031701002,"Census Tract 7010.02, Montgomery County, Maryland",3529,92,92,72,47,0,45,45,45,18,0,140,140,128,58,0,91,79,69,23,12,3161,3113,2918,642,48
1400000US24031701004,"Census Tract 7010.04, Montgomery County, Maryland",5575,284,233,130,126,51,745,624,338,401,121,611,553,454,160,58,635,630,525,154,5,3300,3244,3083,613,56
1400000US24031701005,"Census Tract 7010.05, Montgomery County, Maryland",3533,92,83,22,76,9,209,177,126,101,32,183,173,173,71,10,437,437,344,142,0,2612,2522,2467,321,90
1400000US24031701006,"Census Tract 7010.06, Montgomery County, Maryland",5190,30,30,30,30,0,260,250,183,174,10,486,486,443,193,0,346,329,314,131,17,4068,3993,3730,748,75
1400000US24031701007,"Census Tract 7010.07, Montgomery County, Maryland",3197,169,169,52,134,0,220,164,140,41,56,369,340,302,47,29,411,403,357,111,8,2028,1996,1880,346,32
1400000US24031701101,"Census Tract 7011.01, Montgomery County, Maryland",4841,62,55,37,27,7,279,271,225,73,8,909,464,310,232,445,326,262,235,36,64,3265,2843,2556,682,422
1400000US24031701102,"Census Tract 7011.02, Montgomery County, Maryland",6506,266,211,95,149,55,1173,424,224,310,749,1054,955,586,473,99,1642,869,683,292,773,2371,2230,2085,327,141
1400000US24031701201,"Census Tract 7012.01, Montgomery County, Maryland",5964,668,475,83,408,193,1015,767,559,433,248,1285,1153,1023,268,132,822,769,438,437,53,2174,2021,1951,271,153
1400000US24031701202,"Census Tract 7012.02, Montgomery County, Maryland",2797,63,63,33,54,0,125,122,91,76,3,110,110,103,64,0,289,289,228,75,0,2210,2191,2134,281,19
1400000US24031701205,"Census Tract 7012.05, Montgomery County, Maryland",6713,97,65,46,19,32,276,225,192,125,51,209,168,123,90,41,419,419,388,149,0,5712,5625,5393,1096,87
1400000US24031701206,"Census Tract 7012.06, Montgomery County, Maryland",6395,114,114,114,68,0,209,209,209,168,0,283,283,218,134,0,362,350,350,68,12,5427,5255,5003,723,172
1400000US24031701210,"Census Tract 7012.10, Montgomery County, Maryland",3949,112,112,107,44,0,74,74,74,34,0,189,189,174,110,0,49,39,39,30,10,3525,3414,3288,598,111
1400000US24031701211,"Census Tract 7012.11, Montgomery County, Maryland",6283,602,569,300,350,33,719,667,523,249,52,1148,1087,865,302,61,387,387,387,59,0,3427,3254,3134,485,173
1400000US24031701212,"Census Tract 7012.12, Montgomery County, Maryland",2913,40,40,40,5,0,213,188,72,158,25,325,300,300,31,25,223,223,186,92,0,2112,2073,1977,341,39
1400000US24031701213,"Census Tract 7012.13, Montgomery County, Maryland",7030,592,592,535,139,0,466,448,346,188,18,621,482,420,149,139,928,928,908,171,0,4423,4270,4171,785,153
1400000US24031701214,"Census Tract 7012.14, Montgomery County, Maryland",3695,188,188,166,22,0,196,196,157,62,0,386,372,353,82,14,695,661,577,127,34,2230,2128,2092,141,102
1400000US24031701215,"Census Tract 7012.15, Montgomery County, Maryland",4794,307,278,182,134,29,697,642,472,312,55,485,485,433,179,0,474,474,438,75,0,2831,2831,2776,397,0
1400000US24031701216,"Census Tract 7012.16, Montgomery County, Maryland",4691,564,491,198,385,73,543,463,309,213,80,436,397,383,77,39,544,544,530,112,0,2604,2559,2398,385,45
1400000US24031701218,"Census Tract 7012.18, Montgomery County, Maryland",2450,291,261,148,171,30,337,297,165,228,40,382,374,346,78,8,471,461,431,70,10,969,954,920,110,15
1400000US24031701219,"Census Tract 7012.19, Montgomery County, Maryland",4220,491,440,357,118,51,1006,793,525,278,213,1359,1224,912,398,135,292,255,255,0,37,1072,978,969,48,94
1400000US24031701220,"Census Tract 7012.20, Montgomery County, Maryland",3884,117,117,89,39,0,138,138,138,35,0,141,141,141,10,0,147,147,141,57,0,3341,3262,3162,335,79
1400000US24031701221,"Census Tract 7012.21, Montgomery County, Maryland",4411,195,195,71,165,0,433,397,307,144,36,179,179,147,43,0,414,373,317,78,41,3190,3101,2993,377,89
1400000US24031701303,"Census Tract 7013.03, Montgomery County, Maryland",3376,142,142,133,75,0,148,148,120,109,0,263,252,227,127,11,157,157,139,83,0,2666,2666,2613,449,0
1400000US24031701304,"Census Tract 7013.04, Montgomery County, Maryland",5995,92,92,59,92,0,529,522,485,158,7,787,698,560,406,89,752,705,661,183,47,3835,3835,3714,608,0
1400000US24031701306,"Census Tract 7013.06, Montgomery County, Maryland",3045,86,46,46,20,40,71,71,54,37,0,217,217,175,103,0,297,288,278,52,9,2374,2336,2245,342,38
1400000US24031701307,"Census Tract 7013.07, Montgomery County, Maryland",4317,206,198,135,87,8,167,157,107,73,10,250,250,237,36,0,407,407,328,115,0,3287,3176,3082,326,111
1400000US24031701308,"Census Tract 7013.08, Montgomery County, Maryland",3206,131,131,9,131,0,169,169,157,51,0,181,181,129,86,0,221,204,198,28,17,2504,2470,2422,295,34
1400000US24031701312,"Census Tract 7013.12, Montgomery County, Maryland",6515,46,46,31,46,0,152,152,75,77,0,535,530,511,71,5,639,624,404,390,15,5143,5105,4979,540,38
1400000US24031701313,"Census Tract 7013.13, Montgomery County, Maryland",3728,49,49,49,49,0,81,81,70,33,0,161,144,83,71,17,449,449,415,145,0,2988,2911,2639,536,77
1400000US24031701314,"Census Tract 7013.14, Montgomery County, Maryland",3249,115,115,42,82,0,395,363,186,199,32,377,359,337,53,18,359,352,345,50,7,2003,1977,1932,219,26
1400000US24031701315,"Census Tract 7013.15, Montgomery County, Maryland",4634,267,267,68,237,0,122,122,99,91,0,905,884,705,383,21,461,461,446,35,0,2879,2816,2768,240,63
1400000US24031701316,"Census Tract 7013.16, Montgomery County, Maryland",6195,174,174,81,157,0,545,522,331,416,23,581,581,310,478,0,292,278,264,136,14,4603,4408,4280,464,195
1400000US24031701317,"Census Tract 7013.17, Montgomery County, Maryland",4454,41,29,24,13,12,296,296,222,120,0,334,276,183,134,58,323,286,278,46,37,3460,3321,3182,471,139
1400000US24031701407,"Census Tract 7014.07, Montgomery County, Maryland",5707,165,165,165,20,0,258,258,164,214,0,337,327,223,135,10,1001,858,698,220,143,3946,3903,3772,741,43
1400000US24031701408,"Census Tract 7014.08, Montgomery County, Maryland",6646,460,366,252,321,94,296,296,172,252,0,918,821,664,257,97,554,488,333,276,66,4418,4349,4076,871,69
1400000US24031701409,"Census Tract 7014.09, Montgomery County, Maryland",4583,197,118,82,68,79,239,227,200,139,12,304,279,267,127,25,590,520,349,295,70,3253,3076,2865,370,177
1400000US24031701410,"Census Tract 7014.10, Montgomery County, Maryland",9252,299,299,86,231,0,1128,790,500,309,338,1321,1295,1010,285,26,1826,1512,1270,401,314,4678,4330,4079,347,348
1400000US24031701414,"Census Tract 7014.14, Montgomery County, Maryland",7404,356,280,122,206,76,1483,850,568,379,633,981,561,383,280,420,686,686,501,232,0,3898,3596,3242,886,302
1400000US24031701415,"Census Tract 7014.15, Montgomery County, Maryland",7751,228,174,36,154,54,748,671,454,248,77,1276,1234,1090,361,42,775,720,720,145,55,4724,4186,3812,822,538
1400000US24031701417,"Census Tract 7014.17, Montgomery County, Maryland",5816,384,305,151,178,79,579,515,490,112,64,1169,884,868,206,285,979,947,922,90,32,2705,2662,2590,247,43
1400000US24031701418,"Census Tract 7014.18, Montgomery County, Maryland",3481,124,111,38,103,13,307,270,160,123,37,409,394,333,132,15,278,241,189,67,37,2363,2200,1960,388,163
1400000US24031701420,"Census Tract 7014.20, Montgomery County, Maryland",6635,457,457,279,443,0,723,723,492,691,0,1210,1210,940,784,0,629,602,602,404,27,3616,3527,3075,1082,89
1400000US24031701421,"Census Tract 7014.21, Montgomery County, Maryland",2062,76,30,7,23,46,297,204,109,129,93,545,445,157,299,100,293,261,210,65,32,851,700,612,139,151
1400000US24031701422,"Census Tract 7014.22, Montgomery County, Maryland",3282,236,218,158,144,18,1160,814,438,429,346,839,732,510,270,107,671,535,436,99,136,376,313,298,79,63
1400000US24031701423,"Census Tract 7014.23, Montgomery County, Maryland",4691,561,418,49,381,143,1045,952,653,348,93,766,657,480,240,109,465,443,414,52,22,1854,1759,1683,172,95
1400000US24031701503,"Census Tract 7015.03, Montgomery County, Maryland",6789,378,378,216,290,0,414,197,165,183,217,531,531,454,239,0,499,455,443,129,44,4967,4782,4097,1327,185
1400000US24031701505,"Census Tract 7015.05, Montgomery County, Maryland",7209,425,411,251,276,14,1576,1344,640,787,232,532,387,294,123,145,1062,1043,960,253,19,3614,3139,2816,600,475
1400000US24031701506,"Census Tract 7015.06, Montgomery County, Maryland",5173,174,174,45,155,0,485,460,203,316,25,330,272,197,156,58,436,436,408,188,0,3748,3543,3231,664,205
1400000US24031701507,"Census Tract 7015.07, Montgomery County, Maryland",4970,138,138,43,131,0,632,438,207,381,194,272,214,191,121,58,673,659,611,211,14,3255,3155,2972,749,100
1400000US24031701508,"Census Tract 7015.08, Montgomery County, Maryland",4062,787,591,130,493,196,911,831,338,511,80,797,670,446,294,127,579,550,500,67,29,988,947,840,216,41
1400000US24031701509,"Census Tract 7015.09, Montgomery County, Maryland",6740,1263,1075,338,873,188,1789,1548,675,954,241,1515,1240,759,536,275,759,632,492,219,127,1414,1132,908,355,282
1400000US24031701601,"Census Tract 7016.01, Montgomery County, Maryland",2622,331,258,78,189,73,587,380,128,286,207,674,489,262,250,185,325,236,194,47,89,705,502,362,169,203
1400000US24031701602,"Census Tract 7016.02, Montgomery County, Maryland",7260,425,277,89,211,148,1613,1135,343,924,478,1408,1111,690,499,297,1300,879,487,428,421,2514,2120,1735,525,394
1400000US24031701701,"Census Tract 7017.01, Montgomery County, Maryland",3406,334,315,167,276,19,306,228,132,123,78,170,150,141,28,20,144,135,113,22,9,2452,2344,2263,153,108
1400000US24031701702,"Census Tract 7017.02, Montgomery County, Maryland",2387,397,241,61,184,156,709,584,312,304,125,434,350,225,134,84,378,244,188,64,134,469,430,407,48,39
1400000US24031701703,"Census Tract 7017.03, Montgomery County, Maryland",3589,76,57,27,30,19,400,289,199,101,111,498,428,344,117,70,533,488,403,100,45,2082,1995,1922,166,87
1400000US24031701704,"Census Tract 7017.04, Montgomery County, Maryland",3018,165,165,36,129,0,293,286,160,141,7,282,255,154,160,27,178,172,140,55,6,2100,2079,2059,138,21
1400000US24031701800,"Census Tract 7018, Montgomery County, Maryland",4994,301,301,137,185,0,797,691,268,516,106,967,749,566,297,218,531,482,379,163,49,2398,2310,2221,295,88
1400000US24031701900,"Census Tract 7019, Montgomery County, Maryland",3242,138,94,66,86,44,687,553,296,294,134,639,528,407,143,111,504,315,205,110,189,1274,1046,849,251,228
1400000US24031702000,"Census Tract 7020, Montgomery County, Maryland",5717,867,585,155,455,282,1311,949,256,728,362,1810,1127,477,661,683,730,495,356,190,235,999,883,598,297,116
1400000US24031702101,"Census Tract 7021.01, Montgomery County, Maryland",6093,457,395,100,368,62,1868,1436,534,928,432,1340,793,342,484,547,462,382,210,237,80,1966,1786,1560,452,180
1400000US24031702102,"Census Tract 7021.02, Montgomery County, Maryland",3332,64,64,55,24,0,75,75,13,62,0,239,239,232,62,0,360,339,330,81,21,2594,2533,2450,234,61
1400000US24031702200,"Census Tract 7022, Montgomery County, Maryland",5029,60,60,36,60,0,367,291,82,235,76,483,383,217,225,100,316,289,248,95,27,3803,3662,3518,722,141
1400000US24031702301,"Census Tract 7023.01, Montgomery County, Maryland",3698,553,336,130,244,217,1206,692,374,360,514,788,477,328,195,311,375,328,315,26,47,776,752,752,42,24
1400000US24031702302,"Census Tract 7023.02, Montgomery County, Maryland",4011,629,569,118,486,60,818,654,488,228,164,400,330,202,159,70,330,330,300,172,0,1834,1779,1728,203,55
1400000US24031702401,"Census Tract 7024.01, Montgomery County, Maryland",2546,79,79,79,42,0,185,185,123,108,0,140,140,100,46,0,298,284,237,58,14,1844,1819,1769,229,25
1400000US24031702402,"Census Tract 7024.02, Montgomery County, Maryland",4306,322,297,78,242,25,720,663,425,292,57,807,807,767,118,0,380,380,356,95,0,2077,2060,2009,152,17
1400000US24031702500,"Census Tract 7025, Montgomery County, Maryland",7040,1556,1426,700,901,130,992,921,662,367,71,855,769,726,87,86,886,865,835,123,21,2751,2722,2675,165,29
1400000US24031702601,"Census Tract 7026.01, Montgomery County, Maryland",4549,468,407,259,186,61,994,952,768,410,42,580,561,541,62,19,745,643,643,12,102,1762,1739,1630,187,23
1400000US24031702602,"Census Tract 7026.02, Montgomery County, Maryland",5159,653,580,295,330,73,1018,821,516,328,197,641,615,615,49,26,859,555,480,99,304,1988,1816,1683,155,172
1400000US24031702700,"Census Tract 7027, Montgomery County, Maryland",7303,803,803,624,562,0,1281,1109,691,466,172,745,539,250,321,206,1270,1150,518,697,120,3204,3084,2913,522,120
1400000US24031702800,"Census Tract 7028, Montgomery County, Maryland",5123,163,163,118,59,0,323,307,307,62,16,731,731,711,123,0,884,729,711,81,155,3022,2984,2894,258,38
1400000US24031702900,"Census Tract 7029, Montgomery County, Maryland",5217,277,277,141,205,0,257,257,124,161,0,495,442,425,137,53,388,388,360,127,0,3800,3739,3691,536,61
1400000US24031703000,"Census Tract 7030, Montgomery County, Maryland",1882,84,84,32,72,0,32,28,23,10,4,96,92,87,10,4,274,246,201,78,28,1396,1376,1329,150,20
1400000US24031703100,"Census Tract 7031, Montgomery County, Maryland",4524,236,236,90,184,0,318,261,155,183,57,564,350,313,84,214,362,362,353,16,0,3044,2728,2569,418,316
1400000US24031703201,"Census Tract 7032.01, Montgomery County, Maryland",7878,357,292,165,178,65,554,406,207,264,148,1137,882,832,155,255,877,775,654,246,102,4953,4545,4247,795,408
1400000US24031703202,"Census Tract 7032.02, Montgomery County, Maryland",5893,190,190,190,109,0,307,307,232,239,0,485,469,428,159,16,464,433,379,201,31,4447,4286,4029,897,161
1400000US24031703206,"Census Tract 7032.06, Montgomery County, Maryland",3707,166,128,90,74,38,488,450,201,294,38,501,451,385,184,50,705,624,559,136,81,1847,1840,1717,449,7
1400000US24031703207,"Census Tract 7032.07, Montgomery County, Maryland",6249,773,568,25,554,205,1855,1336,252,1189,519,1150,656,311,373,494,789,634,316,382,155,1682,1615,1361,435,67
1400000US24031703208,"Census Tract 7032.08, Montgomery County, Maryland",5389,216,216,77,177,0,501,501,467,110,0,341,305,154,204,36,670,623,559,193,47,3661,3281,2924,866,380
1400000US24031703209,"Census Tract 7032.09, Montgomery County, Maryland",6442,465,465,194,436,0,779,624,301,387,155,1009,819,424,476,190,1171,833,774,144,338,3018,2795,2639,443,223
1400000US24031703210,"Census Tract 7032.10, Montgomery County, Maryland",3409,96,96,24,96,0,526,466,163,368,60,695,480,270,286,215,363,352,265,128,11,1729,1621,1405,341,108
1400000US24031703212,"Census Tract 7032.12, Montgomery County, Maryland",9694,742,742,215,588,0,1147,902,282,712,245,558,534,323,243,24,1780,1212,860,547,568,5467,5131,4845,743,336
1400000US24031703213,"Census Tract 7032.13, Montgomery County, Maryland",6409,1317,1265,239,1067,52,2332,1568,803,794,764,1154,914,567,347,240,835,662,461,250,173,771,609,585,53,162
1400000US24031703214,"Census Tract 7032.14, Montgomery County, Maryland",7819,739,583,138,531,156,2034,1427,365,1075,607,1531,1044,592,494,487,1375,924,588,399,451,2140,2084,2024,318,56
1400000US24031703215,"Census Tract 7032.15, Montgomery County, Maryland",3255,60,60,21,60,0,540,505,391,175,35,571,475,331,210,96,385,317,273,63,68,1699,1473,1314,279,226
1400000US24031703216,"Census Tract 7032.16, Montgomery County, Maryland",3821,470,470,314,401,0,748,724,613,586,24,856,661,532,426,195,362,346,288,227,16,1385,1290,1202,422,95
1400000US24031703218,"Census Tract 7032.18, Montgomery County, Maryland",1868,317,317,256,307,0,390,390,334,365,0,490,490,367,444,0,257,257,235,216,0,414,414,407,354,0
1400000US24031703219,"Census Tract 7032.19, Montgomery County, Maryland",3386,676,676,460,665,0,725,725,523,647,0,716,700,565,650,16,541,525,494,437,16,728,728,681,645,0
1400000US24031703220,"Census Tract 7032.20, Montgomery County, Maryland",5153,634,558,204,536,76,967,798,452,475,169,1324,1061,684,512,263,804,748,583,176,56,1424,1402,1338,170,22
1400000US24031703221,"Census Tract 7032.21, Montgomery County, Maryland",5405,263,219,103,146,44,916,510,231,306,406,452,435,360,122,17,784,681,607,136,103,2990,2811,2561,531,179
1400000US24031703301,"Census Tract 7033.01, Montgomery County, Maryland",5246,185,143,35,123,42,607,427,238,265,180,789,694,542,306,95,1067,1006,851,263,61,2598,2185,1674,678,413
1400000US24031703302,"Census Tract 7033.02, Montgomery County, Maryland",4512,80,80,18,73,0,875,476,130,392,399,667,378,292,132,289,908,655,250,410,253,1982,1836,1499,546,146
1400000US24031703401,"Census Tract 7034.01, Montgomery County, Maryland",5458,367,273,140,183,94,415,304,246,123,111,1442,1239,1085,202,203,1164,836,660,252,328,2070,1668,1470,351,402
1400000US24031703402,"Census Tract 7034.02, Montgomery County, Maryland",3580,237,230,168,121,7,870,823,354,505,47,593,550,295,318,43,712,689,589,165,23,1168,1122,1065,141,46
1400000US24031703403,"Census Tract 7034.03, Montgomery County, Maryland",3580,327,327,84,263,0,528,431,208,304,97,779,599,332,313,180,599,536,415,171,63,1347,1196,1012,353,151
1400000US24031703404,"Census Tract 7034.04, Montgomery County, Maryland",3303,183,145,21,133,38,539,211,64,170,328,940,592,320,316,348,641,550,402,174,91,1000,758,673,133,242
1400000US24031703501,"Census Tract 7035.01, Montgomery County, Maryland",6430,765,657,278,463,108,1113,900,480,500,213,1245,968,700,313,277,1542,1336,846,583,206,1765,1397,1269,266,368
1400000US24031703502,"Census Tract 7035.02, Montgomery County, Maryland",2777,231,231,64,194,0,500,461,255,326,39,270,236,183,120,34,331,261,237,82,70,1445,1400,1339,213,45
1400000US24031703601,"Census Tract 7036.01, Montgomery County, Maryland",4778,288,288,80,239,0,421,393,310,211,28,690,683,545,240,7,739,555,463,125,184,2640,2442,2249,379,198
1400000US24031703602,"Census Tract 7036.02, Montgomery County, Maryland",3112,108,108,19,89,0,90,78,55,34,12,587,329,183,186,258,303,283,283,29,20,2024,2013,1963,191,11
1400000US24031703701,"Census Tract 7037.01, Montgomery County, Maryland",4417,151,127,108,58,24,562,520,396,149,42,1306,884,326,569,422,853,743,509,330,110,1545,1204,933,384,341
1400000US24031703702,"Census Tract 7037.02, Montgomery County, Maryland",4386,584,353,30,345,231,337,256,159,156,81,800,770,605,208,30,460,377,274,154,83,2205,1668,1490,289,537
1400000US24031703800,"Census Tract 7038, Montgomery County, Maryland",3508,574,437,186,259,137,720,482,275,207,238,513,486,426,111,27,394,394,394,99,0,1307,1231,1219,97,76
1400000US24031703901,"Census Tract 7039.01, Montgomery County, Maryland",3331,151,121,16,105,30,120,120,116,85,0,377,327,243,123,50,460,364,245,145,96,2223,2111,1912,352,112
1400000US24031703902,"Census Tract 7039.02, Montgomery County, Maryland",7266,339,317,196,216,22,846,716,449,372,130,823,723,605,169,100,1193,1097,852,347,96,4065,3304,3023,427,761
1400000US24031704000,"Census Tract 7040, Montgomery County, Maryland",6437,724,663,284,492,61,953,898,403,615,55,667,569,559,82,98,598,587,530,134,11,3495,3168,2739,694,327
1400000US24031704100,"Census Tract 7041, Montgomery County, Maryland",4558,214,214,163,85,0,69,69,42,63,0,238,200,167,73,38,265,265,239,130,0,3772,3747,3665,619,25
1400000US24031704200,"Census Tract 7042, Montgomery County, Maryland",2145,92,92,48,75,0,126,120,88,59,6,239,194,156,63,45,293,286,229,92,7,1395,1391,1373,158,4
1400000US24031704300,"Census Tract 7043, Montgomery County, Maryland",3984,72,35,28,27,37,127,127,100,80,0,148,148,122,44,0,301,301,295,106,0,3336,3322,3267,268,14
1400000US24031704401,"Census Tract 7044.01, Montgomery County, Maryland",3284,62,62,40,42,0,218,218,132,105,0,141,141,104,56,0,101,101,72,46,0,2762,2691,2589,326,71
1400000US24031704403,"Census Tract 7044.03, Montgomery County, Maryland",1616,79,79,42,67,0,127,114,105,106,13,388,365,275,149,23,216,216,195,58,0,806,792,745,237,14
1400000US24031704404,"Census Tract 7044.04, Montgomery County, Maryland",5118,104,93,66,27,11,323,310,258,201,13,513,429,282,186,84,490,490,371,231,0,3688,3652,3534,557,36
1400000US24031704501,"Census Tract 7045.01, Montgomery County, Maryland",3514,37,37,24,37,0,57,50,50,32,7,255,226,212,60,29,337,329,329,51,8,2828,2802,2749,291,26
1400000US24031704502,"Census Tract 7045.02, Montgomery County, Maryland",2516,27,27,27,27,0,91,91,91,21,0,69,69,60,41,0,78,78,63,20,0,2251,2244,2205,382,7
1400000US24031704503,"Census Tract 7045.03, Montgomery County, Maryland",4093,26,26,16,10,0,55,42,33,36,13,100,100,89,45,0,63,63,63,40,0,3849,3726,3593,570,123
1400000US24031704600,"Census Tract 7046, Montgomery County, Maryland",4887,71,71,71,56,0,86,86,46,47,0,165,147,133,62,18,227,227,182,85,0,4338,4309,4234,617,29
1400000US24031704700,"Census Tract 7047, Montgomery County, Maryland",3748,35,35,19,25,0,85,85,76,18,0,160,150,143,79,10,222,222,191,74,0,3246,3231,3132,599,15
1400000US24031704803,"Census Tract 7048.03, Montgomery County, Maryland",3785,322,289,150,184,33,457,457,412,115,0,1115,954,865,200,161,359,359,350,33,0,1532,1532,1509,190,0
1400000US24031704804,"Census Tract 7048.04, Montgomery County, Maryland",1662,126,111,95,54,15,104,92,87,22,12,153,150,145,35,3,176,176,163,21,0,1103,1103,1084,176,0
1400000US24031704805,"Census Tract 7048.05, Montgomery County, Maryland",1991,332,319,216,208,13,104,104,80,24,0,216,205,187,53,11,180,180,155,40,0,1159,1159,1121,85,0
1400000US24031704806,"Census Tract 7048.06, Montgomery County, Maryland",3206,294,277,178,99,17,316,297,269,76,19,463,451,451,33,12,387,387,387,83,0,1746,1713,1713,186,33
1400000US24031705000,"Census Tract 7050, Montgomery County, Maryland",4161,104,94,67,55,10,229,229,115,196,0,179,166,148,49,13,245,245,245,103,0,3404,3379,3271,441,25
1400000US24031705100,"Census Tract 7051, Montgomery County, Maryland",5018,172,92,92,49,80,99,99,60,60,0,202,202,189,121,0,273,269,240,94,4,4272,4176,3945,804,96
1400000US24031705200,"Census Tract 7052, Montgomery County, Maryland",3297,22,20,20,13,2,111,111,65,111,0,84,84,77,27,0,69,69,69,14,0,3011,2987,2918,487,24
1400000US24031705300,"Census Tract 7053, Montgomery County, Maryland",1919,29,26,22,19,3,39,31,19,28,8,43,43,37,24,0,57,57,54,27,0,1751,1745,1676,309,6
1400000US24031705400,"Census Tract 7054, Montgomery County, Maryland",2950,21,21,13,17,0,48,48,42,6,0,55,55,45,40,0,51,51,51,36,0,2775,2768,2725,396,7
1400000US24031705501,"Census Tract 7055.01, Montgomery County, Maryland",2595,147,147,122,56,0,216,196,128,172,20,277,267,247,94,10,416,404,365,133,12,1539,1471,1308,670,68
1400000US24031705502,"Census Tract 7055.02, Montgomery County, Maryland",3916,79,79,28,70,0,176,153,131,78,23,61,61,61,21,0,237,237,225,86,0,3363,3359,3263,692,4
1400000US24031705601,"Census Tract 7056.01, Montgomery County, Maryland",2929,7,7,7,7,0,15,15,15,15,0,119,119,119,33,0,90,90,90,17,0,2698,2673,2629,343,25
1400000US24031705602,"Census Tract 7056.02, Montgomery County, Maryland",4877,474,454,343,213,20,523,463,429,96,60,480,480,416,75,0,508,508,476,176,0,2892,2466,2354,801,426
1400000US24031705701,"Census Tract 7057.01, Montgomery County, Maryland",4525,118,108,87,48,10,250,218,182,106,32,198,171,171,31,27,364,364,341,132,0,3595,3573,3501,451,22
1400000US24031705702,"Census Tract 7057.02, Montgomery County, Maryland",4559,114,114,95,44,0,108,108,24,95,0,370,370,307,143,0,178,178,178,70,0,3789,3789,3620,923,0
1400000US24031705800,"Census Tract 7058, Montgomery County, Maryland",6041,108,91,91,27,17,181,181,149,88,0,147,120,109,89,27,327,326,294,90,1,5278,5237,5159,859,41
1400000US24031705901,"Census Tract 7059.01, Montgomery County, Maryland",4136,36,36,36,36,0,161,161,137,80,0,122,122,93,90,0,72,72,72,36,0,3745,3702,3536,752,43
1400000US24031705902,"Census Tract 7059.02, Montgomery County, Maryland",4093,89,89,89,52,0,93,93,67,40,0,171,171,171,7,0,156,156,121,123,0,3584,3511,3335,669,73
1400000US24031705903,"Census Tract 7059.03, Montgomery County, Maryland",4377,105,105,105,13,0,136,136,136,48,0,217,213,175,92,4,237,237,233,72,0,3682,3630,3515,560,52
1400000US24031706005,"Census Tract 7060.05, Montgomery County, Maryland",4434,75,75,75,46,0,172,164,164,53,8,156,156,130,94,0,223,223,180,121,0,3808,3747,3543,685,61
1400000US24031706007,"Census Tract 7060.07, Montgomery County, Maryland",7377,150,150,16,134,0,126,126,41,99,0,293,293,293,71,0,317,317,219,200,0,6491,6300,6052,967,191
1400000US24031706008,"Census Tract 7060.08, Montgomery County, Maryland",5533,134,134,134,27,0,70,70,70,41,0,233,198,161,77,35,220,207,162,62,13,4876,4865,4620,901,11
1400000US24031706009,"Census Tract 7060.09, Montgomery County, Maryland",5338,135,135,110,34,0,230,230,66,183,0,162,162,128,70,0,128,128,128,57,0,4683,4528,4296,854,155
1400000US24031706010,"Census Tract 7060.10, Montgomery County, Maryland",3097,68,58,50,53,10,243,147,82,88,96,371,371,245,246,0,242,242,194,77,0,2173,2114,2055,302,59
1400000US24031706011,"Census Tract 7060.11, Montgomery County, Maryland",5319,117,107,67,49,10,99,99,72,54,0,80,80,80,65,0,297,287,251,153,10,4726,4662,4537,812,64
1400000US24031706012,"Census Tract 7060.12, Montgomery County, Maryland",3337,464,443,137,408,21,592,566,299,363,26,496,441,349,171,55,378,378,349,72,0,1407,1343,1272,189,64
1400000US24031706013,"Census Tract 7060.13, Montgomery County, Maryland",2956,61,55,44,25,6,61,49,31,37,12,133,133,114,48,0,105,105,96,70,0,2596,2542,2374,443,54
1400000US24033800102,"Census Tract 8001.02, Prince George's County, Maryland",2606,305,250,116,218,55,300,300,224,124,0,509,480,325,215,29,391,373,320,53,18,1101,1048,1020,69,53
1400000US24033800103,"Census Tract 8001.03, Prince George's County, Maryland",2270,232,184,141,61,48,440,369,254,128,71,486,433,244,207,53,290,264,264,66,26,822,734,624,148,88
1400000US24033800105,"Census Tract 8001.05, Prince George's County, Maryland",3876,297,179,61,142,118,381,368,153,256,13,768,567,352,321,201,731,697,643,109,34,1699,1591,1553,158,108
1400000US24033800106,"Census Tract 8001.06, Prince George's County, Maryland",2848,152,133,72,125,19,283,258,174,157,25,268,226,226,10,42,601,520,475,96,81,1544,1447,1400,98,97
1400000US24033800108,"Census Tract 8001.08, Prince George's County, Maryland",3414,347,238,198,129,109,657,541,292,297,116,1007,867,720,228,140,208,200,195,38,8,1195,1127,1076,160,68
1400000US24033800109,"Census Tract 8001.09, Prince George's County, Maryland",3597,446,392,127,329,54,754,489,187,328,265,612,516,406,195,96,637,576,499,105,61,1148,1062,934,239,86
1400000US24033800203,"Census Tract 8002.03, Prince George's County, Maryland",4436,93,93,63,93,0,213,197,169,81,16,599,555,435,258,44,465,452,357,228,13,3066,2963,2772,598,103
1400000US24033800206,"Census Tract 8002.06, Prince George's County, Maryland",4084,149,146,114,50,3,593,446,301,232,147,999,981,759,272,18,729,634,595,100,95,1614,1592,1524,222,22
1400000US24033800208,"Census Tract 8002.08, Prince George's County, Maryland",7912,346,249,88,211,97,677,463,162,361,214,880,694,401,349,186,1890,1747,1187,722,143,4119,4012,3744,673,107
1400000US24033800209,"Census Tract 8002.09, Prince George's County, Maryland",4134,711,418,156,321,293,852,608,427,189,244,1036,802,563,278,234,389,370,326,74,19,1146,991,654,354,155
1400000US24033800210,"Census Tract 8002.10, Prince George's County, Maryland",2629,155,111,47,75,44,659,627,395,300,32,553,452,433,19,101,432,364,230,164,68,830,793,774,85,37
1400000US24033800211,"Census Tract 8002.11, Prince George's County, Maryland",3204,223,223,100,211,0,1057,802,602,332,255,443,427,329,106,16,395,367,343,56,28,1086,1048,912,243,38
1400000US24033800212,"Census Tract 8002.12, Prince George's County, Maryland",4415,212,212,187,131,0,577,569,511,182,8,623,503,413,230,120,343,343,343,78,0,2660,2554,2441,340,106
1400000US24033800213,"Census Tract 8002.13, Prince George's County, Maryland",4875,105,105,105,15,0,591,531,213,378,60,986,783,641,207,203,650,650,559,141,0,2543,2261,1682,751,282
1400000US24033800214,"Census Tract 8002.14, Prince George's County, Maryland",2440,136,119,67,96,17,372,329,166,186,43,911,697,646,75,214,381,381,370,42,0,640,586,529,86,54
1400000US24033800215,"Census Tract 8002.15, Prince George's County, Maryland",2583,144,115,89,26,29,243,210,119,101,33,611,611,603,39,0,351,351,330,60,0,1234,1216,1011,247,18
1400000US24033800401,"Census Tract 8004.01, Prince George's County, Maryland",2353,62,50,35,22,12,237,160,89,120,77,227,218,158,150,9,325,325,290,93,0,1502,1435,1409,221,67
1400000US24033800402,"Census Tract 8004.02, Prince George's County, Maryland",4643,151,124,89,78,27,336,308,266,202,28,621,549,408,256,72,635,620,540,225,15,2900,2841,2698,545,59
1400000US24033800403,"Census Tract 8004.03, Prince George's County, Maryland",3786,254,233,98,190,21,151,145,120,90,6,733,656,489,362,77,355,340,285,112,15,2293,2248,2161,461,45
1400000US24033800408,"Census Tract 8004.08, Prince George's County, Maryland",7132,230,190,41,161,40,174,140,140,12,34,1199,899,542,465,300,618,534,433,290,84,4911,4734,4518,693,177
1400000US24033800409,"Census Tract 8004.09, Prince George's County, Maryland",6098,392,208,173,111,184,448,418,362,192,30,568,538,538,87,30,485,424,327,170,61,4205,4180,4043,728,25
1400000US24033800410,"Census Tract 8004.10, Prince George's County, Maryland",5716,85,85,19,74,0,304,288,175,175,16,313,313,253,86,0,1004,830,704,211,174,4010,3925,3677,441,85
1400000US24033800411,"Census Tract 8004.11, Prince George's County, Maryland",3849,64,58,58,7,6,346,346,219,182,0,432,423,235,276,9,609,453,305,238,156,2398,2347,2186,368,51
1400000US24033800412,"Census Tract 8004.12, Prince George's County, Maryland",3605,205,178,66,121,27,482,379,305,166,103,939,907,704,315,32,567,539,459,125,28,1412,1292,1142,426,120
1400000US24033800413,"Census Tract 8004.13, Prince George's County, Maryland",4157,310,237,0,237,73,903,706,409,364,197,724,572,352,249,152,698,652,465,234,46,1522,1309,1105,282,213
1400000US24033800504,"Census Tract 8005.04, Prince George's County, Maryland",4791,178,164,126,133,14,357,333,256,267,24,776,677,614,127,99,459,459,373,194,0,3021,2788,2613,630,233
1400000US24033800505,"Census Tract 8005.05, Prince George's County, Maryland",2424,52,39,18,39,13,124,124,110,65,0,230,192,157,80,38,461,452,405,128,9,1557,1503,1445,329,54
1400000US24033800507,"Census Tract 8005.07, Prince George's County, Maryland",3220,48,38,38,25,10,155,155,155,17,0,434,401,339,115,33,525,507,507,58,18,2058,1974,1858,234,84
1400000US24033800509,"Census Tract 8005.09, Prince George's County, Maryland",10279,415,406,257,261,9,868,868,649,616,0,1078,1078,971,666,0,1243,1213,1125,403,30,6675,6572,6211,1258,103
1400000US24033800511,"Census Tract 8005.11, Prince George's County, Maryland",5129,173,149,38,126,24,636,636,462,237,0,901,842,689,312,59,668,586,499,251,82,2751,2694,2528,483,57
1400000US24033800513,"Census Tract 8005.13, Prince George's County, Maryland",5506,133,103,94,73,30,353,353,280,226,0,380,325,239,191,55,672,661,653,85,11,3968,3814,3714,429,154
1400000US24033800514,"Census Tract 8005.14, Prince George's County, Maryland",5932,107,97,84,13,10,43,43,43,8,0,375,315,315,18,60,220,220,214,37,0,5187,5070,4868,714,117
1400000US24033800515,"Census Tract 8005.15, Prince George's County, Maryland",4172,260,238,206,84,22,394,369,274,247,25,632,512,471,59,120,719,616,613,86,103,2167,2060,1960,295,107
1400000US24033800516,"Census Tract 8005.16, Prince George's County, Maryland",4000,182,172,146,111,10,393,348,284,200,45,604,596,431,203,8,615,564,564,21,51,2206,2145,2078,214,61
1400000US24033800517,"Census Tract 8005.17, Prince George's County, Maryland",6024,107,32,32,21,75,111,108,14,99,3,325,307,288,95,18,950,926,623,450,24,4531,4424,4078,822,107
1400000US24033800518,"Census Tract 8005.18, Prince George's County, Maryland",3689,30,18,8,10,12,210,190,103,108,20,740,651,515,203,89,155,149,138,31,6,2554,2535,2367,403,19
1400000US24033800519,"Census Tract 8005.19, Prince George's County, Maryland",3987,176,167,109,160,9,276,261,228,121,15,491,452,416,73,39,443,367,329,115,76,2601,2451,2257,374,150
1400000US24033800520,"Census Tract 8005.20, Prince George's County, Maryland",1913,189,177,98,142,12,179,140,112,69,39,235,235,157,135,0,410,410,383,41,0,900,825,773,93,75
1400000US24033800601,"Census Tract 8006.01, Prince George's County, Maryland",1891,146,146,75,125,0,306,277,182,146,29,361,334,251,127,27,416,416,351,127,0,662,556,517,145,106
1400000US24033800604,"Census Tract 8006.04, Prince George's County, Maryland",1936,224,224,148,117,0,140,64,55,23,76,373,343,294,81,30,298,293,293,52,5,901,881,856,111,20
1400000US24033800605,"Census Tract 8006.05, Prince George's County, Maryland",4166,60,60,21,43,0,172,163,102,96,9,774,772,463,327,2,508,482,472,63,26,2652,2553,2419,285,99
1400000US24033800606,"Census Tract 8006.06, Prince George's County, Maryland",5433,230,230,106,170,0,523,395,220,225,128,1087,1033,685,399,54,1113,1054,971,131,59,2480,2480,2409,275,0
1400000US24033800607,"Census Tract 8006.07, Prince George's County, Maryland",5911,186,186,130,126,0,175,167,137,59,8,392,366,317,147,26,629,512,437,138,117,4529,4257,3858,844,272
1400000US24033800608,"Census Tract 8006.08, Prince George's County, Maryland",5052,70,54,32,22,16,182,182,98,117,0,166,158,158,9,8,449,442,363,186,7,4185,4039,3953,255,146
1400000US24033800701,"Census Tract 8007.01, Prince George's County, Maryland",6014,201,201,183,138,0,385,353,238,196,32,627,524,436,193,103,418,395,395,53,23,4383,4147,4016,546,236
1400000US24033800704,"Census Tract 8007.04, Prince George's County, Maryland",5050,390,356,332,90,34,662,627,326,360,35,804,795,716,138,9,746,683,609,188,63,2448,2414,2380,276,34
1400000US24033800705,"Census Tract 8007.05, Prince George's County, Maryland",4295,151,151,43,144,0,447,305,158,242,142,452,398,343,172,54,260,248,221,84,12,2985,2921,2825,333,64
1400000US24033800706,"Census Tract 8007.06, Prince George's County, Maryland",3848,121,121,98,110,0,280,270,196,141,10,230,230,198,72,0,180,167,118,132,13,3037,2948,2886,430,89
1400000US24033800707,"Census Tract 8007.07, Prince George's County, Maryland",3074,110,96,29,77,14,506,506,248,374,0,296,292,292,185,4,379,367,319,98,12,1783,1698,1632,291,85
1400000US24033800800,"Census Tract 8008, Prince George's County, Maryland",3512,98,98,52,78,0,319,285,267,76,34,336,254,152,189,82,521,448,348,283,73,2238,1999,1964,305,239
1400000US24033800900,"Census Tract 8009, Prince George's County, Maryland",1478,145,145,57,102,0,313,250,148,140,63,182,158,89,118,24,204,196,189,37,8,634,589,523,135,45
1400000US24033801003,"Census Tract 8010.03, Prince George's County, Maryland",5485,423,264,131,183,159,309,297,207,193,12,445,390,373,132,55,1007,961,868,176,46,3301,3169,3114,391,132
1400000US24033801004,"Census Tract 8010.04, Prince George's County, Maryland",4861,79,79,60,45,0,489,468,301,268,21,402,386,363,86,16,438,408,382,59,30,3453,3395,3134,575,58
1400000US24033801005,"Census Tract 8010.05, Prince George's County, Maryland",4168,77,77,68,57,0,45,45,45,39,0,564,523,432,226,41,334,307,257,111,27,3148,3016,2869,455,132
1400000US24033801006,"Census Tract 8010.06, Prince George's County, Maryland",3582,296,252,199,106,44,237,228,147,140,9,218,199,169,46,19,631,572,487,206,59,2200,2200,2002,590,0
1400000US24033801104,"Census Tract 8011.04, Prince George's County, Maryland",2284,104,104,88,23,0,784,784,760,44,0,283,283,283,19,0,561,561,440,127,0,552,536,536,50,16
1400000US24033801207,"Census Tract 8012.07, Prince George's County, Maryland",4134,212,70,59,44,142,299,287,217,125,12,462,388,302,204,74,301,289,271,35,12,2860,2661,2519,672,199
1400000US24033801208,"Census Tract 8012.08, Prince George's County, Maryland",4334,69,69,13,69,0,53,53,53,44,0,416,380,354,136,36,848,848,673,441,0,2948,2894,2677,577,54
1400000US24033801209,"Census Tract 8012.09, Prince George's County, Maryland",4955,142,74,66,17,68,103,103,43,79,0,864,802,563,378,62,891,827,743,178,64,2955,2847,2524,589,108
1400000US24033801210,"Census Tract 8012.10, Prince George's County, Maryland",4189,178,178,55,148,0,403,297,192,207,106,680,635,376,413,45,560,560,553,114,0,2368,2277,2020,520,91
1400000US24033801211,"Census Tract 8012.11, Prince George's County, Maryland",3061,81,68,58,68,13,133,133,110,77,0,310,310,233,152,0,682,550,334,303,132,1855,1800,1558,460,55
1400000US24033801212,"Census Tract 8012.12, Prince George's County, Maryland",3403,55,55,37,33,0,262,235,219,92,27,492,383,272,197,109,479,354,296,164,125,2115,2071,1876,510,44
1400000US24033801213,"Census Tract 8012.13, Prince George's County, Maryland",3783,115,110,43,90,5,414,369,305,140,45,450,302,282,154,148,549,497,380,206,52,2255,2237,2103,364,18
1400000US24033801214,"Census Tract 8012.14, Prince George's County, Maryland",4431,514,514,254,484,0,715,418,195,337,297,495,374,286,201,121,639,594,580,200,45,2068,1982,1632,478,86
1400000US24033801215,"Census Tract 8012.15, Prince George's County, Maryland",2724,50,50,50,39,0,244,224,141,124,20,273,248,195,90,25,627,568,446,153,59,1530,1381,1325,317,149
1400000US24033801216,"Census Tract 8012.16, Prince George's County, Maryland",3779,79,79,64,79,0,293,293,272,73,0,378,378,347,89,0,610,610,535,162,0,2419,2252,2049,538,167
1400000US24033801217,"Census Tract 8012.17, Prince George's County, Maryland",3387,197,181,91,154,16,79,79,79,20,0,255,240,212,112,15,278,239,239,46,39,2578,2492,2323,390,86
1400000US24033801302,"Census Tract 8013.02, Prince George's County, Maryland",2837,71,68,45,46,3,257,252,89,209,5,104,104,104,20,0,424,366,292,148,58,1981,1940,1768,433,41
1400000US24033801305,"Census Tract 8013.05, Prince George's County, Maryland",6319,269,219,144,166,50,252,226,188,97,26,933,460,381,178,473,546,519,503,166,27,4319,3900,3457,930,419
1400000US24033801307,"Census Tract 8013.07, Prince George's County, Maryland",3791,271,271,115,239,0,290,290,140,216,0,435,388,318,196,47,471,431,386,162,40,2324,2232,2069,887,92
1400000US24033801308,"Census Tract 8013.08, Prince George's County, Maryland",3920,67,59,35,34,8,95,89,55,54,6,640,586,420,415,54,383,383,357,129,0,2735,2407,2283,580,328
1400000US24033801309,"Census Tract 8013.09, Prince George's County, Maryland",3391,206,206,171,63,0,86,50,41,38,36,254,254,153,189,0,353,343,321,143,10,2492,2449,2326,615,43
1400000US24033801310,"Census Tract 8013.10, Prince George's County, Maryland",6345,618,618,50,594,0,332,332,280,102,0,393,389,254,170,4,423,408,372,151,15,4579,4337,4106,844,242
1400000US24033801311,"Census Tract 8013.11, Prince George's County, Maryland",6952,150,150,92,101,0,476,452,159,369,24,552,510,510,199,42,1351,1246,948,619,105,4423,4328,4073,628,95
1400000US24033801312,"Census Tract 8013.12, Prince George's County, Maryland",3981,122,103,63,78,19,521,521,350,254,0,680,618,400,312,62,577,543,483,103,34,2081,1989,1918,313,92
1400000US24033801313,"Census Tract 8013.13, Prince George's County, Maryland",3412,140,130,36,126,10,410,375,272,168,35,418,408,294,237,10,218,194,174,53,24,2226,2151,1924,432,75
1400000US24033801404,"Census Tract 8014.04, Prince George's County, Maryland",4743,350,350,68,297,0,812,726,334,456,86,665,476,468,142,189,344,302,276,125,42,2572,2374,2123,652,198
1400000US24033801405,"Census Tract 8014.05, Prince George's County, Maryland",4654,380,269,78,207,111,945,863,427,549,82,994,704,386,344,290,521,427,358,135,94,1814,1677,1417,446,137
1400000US24033801406,"Census Tract 8014.06, Prince George's County, Maryland",2666,273,235,115,161,38,217,186,133,77,31,539,490,363,180,49,360,360,339,64,0,1277,1261,1196,170,16
1400000US24033801407,"Census Tract 8014.07, Prince George's County, Maryland",6764,250,141,114,112,109,1163,873,420,524,290,1088,1026,968,112,62,910,860,773,298,50,3353,3020,2759,938,333
1400000US24033801408,"Census Tract 8014.08, Prince George's County, Maryland",3254,862,634,125,585,228,464,444,409,117,20,539,518,496,109,21,253,253,227,64,0,1136,1119,1026,335,17
1400000US24033801409,"Census Tract 8014.09, Prince George's County, Maryland",3104,84,67,51,43,17,662,662,392,424,0,816,719,500,362,97,344,310,251,217,34,1198,1120,986,242,78
1400000US24033801410,"Census Tract 8014.10, Prince George's County, Maryland",3179,69,41,16,28,28,229,213,207,108,16,429,324,307,168,105,455,372,339,96,83,1997,1874,1591,683,123
1400000US24033801411,"Census Tract 8014.11, Prince George's County, Maryland",3409,211,182,37,171,29,590,394,109,334,196,242,242,206,120,0,1087,770,658,172,317,1279,1245,1147,302,34
1400000US24033801500,"Census Tract 8015, Prince George's County, Maryland",2650,137,127,66,104,10,472,391,241,218,81,498,445,227,280,53,657,515,328,227,142,886,806,695,288,80
1400000US24033801600,"Census Tract 8016, Prince George's County, Maryland",2478,522,415,70,403,107,946,765,489,357,181,435,375,205,233,60,264,264,198,97,0,311,297,243,126,14
1400000US24033801701,"Census Tract 8017.01, Prince George's County, Maryland",4495,473,431,123,353,42,908,879,508,519,29,887,785,447,444,102,525,478,334,196,47,1702,1549,1284,493,153
1400000US24033801702,"Census Tract 8017.02, Prince George's County, Maryland",4019,388,365,114,277,23,578,516,321,234,62,746,697,557,264,49,681,626,568,130,55,1626,1284,1137,347,342
1400000US24033801704,"Census Tract 8017.04, Prince George's County, Maryland",5885,1132,1011,165,865,121,1381,1069,607,587,312,794,755,502,290,39,778,767,731,62,11,1800,1748,1510,438,52
1400000US24033801706,"Census Tract 8017.06, Prince George's County, Maryland",1591,109,104,52,57,5,137,137,131,26,0,474,379,205,211,95,124,115,115,21,9,747,714,581,280,33
1400000US24033801707,"Census Tract 8017.07, Prince George's County, Maryland",7011,306,251,175,108,55,2047,1356,749,828,691,1997,1218,729,662,779,884,742,738,66,142,1777,1611,1064,634,166
1400000US24033801708,"Census Tract 8017.08, Prince George's County, Maryland",3364,393,286,160,185,107,881,698,333,455,183,616,599,383,274,17,528,510,403,131,18,946,833,776,115,113
1400000US24033801801,"Census Tract 8018.01, Prince George's County, Maryland",1978,279,197,41,169,82,742,703,437,356,39,251,204,160,59,47,340,280,229,132,60,366,349,305,115,17
1400000US24033801802,"Census Tract 8018.02, Prince George's County, Maryland",3618,651,567,304,348,84,821,744,564,242,77,541,541,436,156,0,455,440,359,175,15,1150,1078,910,236,72
1400000US24033801804,"Census Tract 8018.04, Prince George's County, Maryland",2132,100,100,74,59,0,313,303,215,201,10,396,390,267,177,6,350,341,269,199,9,973,763,612,332,210
1400000US24033801805,"Census Tract 8018.05, Prince George's County, Maryland",2423,316,284,86,215,32,467,451,222,345,16,539,463,446,89,76,264,253,179,89,11,837,711,586,293,126
1400000US24033801807,"Census Tract 8018.07, Prince George's County, Maryland",4746,518,464,243,254,54,964,831,546,421,133,595,548,375,251,47,945,875,641,277,70,1724,1724,1577,420,0
1400000US24033801808,"Census Tract 8018.08, Prince George's County, Maryland",3964,357,308,112,223,49,1158,1066,399,774,92,852,732,580,182,120,636,589,542,200,47,961,868,790,181,93
1400000US24033801901,"Census Tract 8019.01, Prince George's County, Maryland",4676,219,206,157,97,13,730,683,296,473,47,1030,928,803,230,102,615,589,548,192,26,2082,1870,1699,594,212
1400000US24033801904,"Census Tract 8019.04, Prince George's County, Maryland",2911,453,330,140,254,123,814,720,479,343,94,323,296,244,89,27,453,379,280,222,74,868,830,727,195,38
1400000US24033801905,"Census Tract 8019.05, Prince George's County, Maryland",5297,96,96,80,48,0,727,718,282,614,9,610,554,463,140,56,1014,926,727,399,88,2850,2757,2399,705,93
1400000US24033801906,"Census Tract 8019.06, Prince George's County, Maryland",1761,155,123,80,59,32,230,199,120,119,31,419,403,333,144,16,318,303,188,164,15,639,537,429,162,102
1400000US24033801907,"Census Tract 8019.07, Prince George's County, Maryland",2713,488,451,233,389,37,286,197,161,93,89,288,288,217,171,0,448,388,354,165,60,1203,1190,1089,226,13
1400000US24033801908,"Census Tract 8019.08, Prince George's County, Maryland",3305,332,252,69,229,80,791,684,543,171,107,892,834,630,313,58,416,378,364,32,38,874,759,665,287,115
1400000US24033802001,"Census Tract 8020.01, Prince George's County, Maryland",6303,1070,957,206,809,113,820,820,652,267,0,1374,1302,801,597,72,948,906,648,306,42,2091,1463,1196,439,628
1400000US24033802002,"Census Tract 8020.02, Prince George's County, Maryland",4013,424,417,187,311,7,713,629,385,298,84,722,568,459,180,154,879,802,726,159,77,1275,1151,981,285,124
1400000US24033802103,"Census Tract 8021.03, Prince George's County, Maryland",3307,223,181,56,173,42,325,317,186,186,8,514,514,509,89,0,464,419,316,121,45,1781,1552,1420,375,229
1400000US24033802104,"Census Tract 8021.04, Prince George's County, Maryland",1885,283,283,68,240,0,218,218,155,145,0,346,321,284,101,25,385,357,278,93,28,653,548,449,155,105
1400000US24033802106,"Census Tract 8021.06, Prince George's County, Maryland",3856,637,562,202,383,75,996,828,373,526,168,816,725,634,172,91,597,566,293,273,31,810,686,670,61,124
1400000US24033802107,"Census Tract 8021.07, Prince George's County, Maryland",3665,354,323,73,269,31,1107,1015,574,510,92,775,675,488,200,100,601,587,485,108,14,828,798,615,183,30
1400000US24033802201,"Census Tract 8022.01, Prince George's County, Maryland",2008,216,190,83,175,26,314,263,234,109,51,549,478,406,167,71,371,279,221,76,92,558,558,519,86,0
1400000US24033802203,"Census Tract 8022.03, Prince George's County, Maryland",4333,437,430,127,383,7,977,871,686,320,106,859,807,765,281,52,552,465,382,157,87,1508,1363,1257,256,145
1400000US24033802204,"Census Tract 8022.04, Prince George's County, Maryland",6201,340,340,133,295,0,388,368,280,153,20,1298,1185,1077,197,113,747,716,561,467,31,3428,3218,2923,704,210
1400000US24033802301,"Census Tract 8023.01, Prince George's County, Maryland",3919,369,360,166,297,9,437,405,355,137,32,805,706,540,200,99,814,720,432,368,94,1494,1427,1249,292,67
1400000US24033802404,"Census Tract 8024.04, Prince George's County, Maryland",3933,780,679,294,456,101,1369,1118,733,537,251,688,680,468,249,8,632,621,347,315,11,464,464,464,37,0
1400000US24033802405,"Census Tract 8024.05, Prince George's County, Maryland",3816,601,563,237,451,38,542,527,213,363,15,824,780,565,336,44,599,563,501,173,36,1250,1152,1004,234,98
1400000US24033802406,"Census Tract 8024.06, Prince George's County, Maryland",2214,361,341,149,216,20,495,424,219,254,71,367,367,318,77,0,414,377,306,121,37,577,510,490,64,67
1400000US24033802407,"Census Tract 8024.07, Prince George's County, Maryland",3388,388,361,159,257,27,937,914,678,355,23,1177,1063,929,227,114,421,373,363,50,48,465,451,442,90,14
1400000US24033802408,"Census Tract 8024.08, Prince George's County, Maryland",1675,229,169,25,157,60,376,329,224,108,47,371,329,221,153,42,265,229,204,78,36,434,430,368,84,4
1400000US24033802501,"Census Tract 8025.01, Prince George's County, Maryland",2731,261,253,98,176,8,651,617,332,331,34,838,771,635,306,67,425,409,361,79,16,556,537,474,63,19
1400000US24033802502,"Census Tract 8025.02, Prince George's County, Maryland",2593,228,193,43,172,35,355,312,186,176,43,688,669,408,328,19,205,198,181,53,7,1117,873,791,198,244
1400000US24033802600,"Census Tract 8026, Prince George's County, Maryland",3554,545,444,68,403,101,713,635,312,368,78,825,622,457,241,203,625,572,394,178,53,846,708,592,263,138
1400000US24033802700,"Census Tract 8027, Prince George's County, Maryland",3153,346,317,119,273,29,614,508,216,396,106,589,484,306,223,105,481,440,392,85,41,1123,895,730,216,228
1400000US24033802803,"Census Tract 8028.03, Prince George's County, Maryland",5679,775,751,189,640,24,1069,1006,672,480,63,927,839,670,248,88,634,575,485,149,59,2274,1955,1768,352,319
1400000US24033802804,"Census Tract 8028.04, Prince George's County, Maryland",5346,779,607,218,505,172,1115,1021,460,764,94,837,825,604,270,12,1061,1035,981,450,26,1554,1475,1305,238,79
1400000US24033802805,"Census Tract 8028.05, Prince George's County, Maryland",4277,644,526,181,452,118,647,538,342,364,109,651,555,329,302,96,964,895,815,227,69,1371,1342,1113,404,29
1400000US24033802901,"Census Tract 8029.01, Prince George's County, Maryland",4204,836,778,190,720,58,683,541,392,196,142,846,826,676,685,20,792,678,379,375,114,1047,962,670,377,85
1400000US24033803001,"Census Tract 8030.01, Prince George's County, Maryland",2931,316,280,81,244,36,543,388,256,203,155,366,272,171,138,94,453,412,374,70,41,1253,1110,820,383,143
1400000US24033803002,"Census Tract 8030.02, Prince George's County, Maryland",2556,123,123,73,99,0,522,508,278,381,14,566,530,420,188,36,456,456,456,8,0,889,853,801,172,36
1400000US24033803100,"Census Tract 8031, Prince George's County, Maryland",2714,281,219,77,175,62,777,741,379,445,36,556,488,380,133,68,455,431,359,114,24,645,610,450,218,35
1400000US24033803200,"Census Tract 8032, Prince George's County, Maryland",2736,505,505,248,283,0,618,507,237,292,111,550,446,310,147,104,506,390,243,176,116,557,500,433,104,57
1400000US24033803300,"Census Tract 8033, Prince George's County, Maryland",4408,800,607,179,507,193,764,597,227,497,167,1113,913,580,495,200,489,417,264,168,72,1242,1066,877,223,176
1400000US24033803401,"Census Tract 8034.01, Prince George's County, Maryland",1233,202,143,22,143,59,234,224,70,172,10,325,233,52,218,92,172,152,147,35,20,300,212,141,88,88
1400000US24033803402,"Census Tract 8034.02, Prince George's County, Maryland",4629,906,854,283,649,52,1590,1521,907,685,69,769,720,593,134,49,559,559,388,317,0,805,722,511,246,83
1400000US24033803508,"Census Tract 8035.08, Prince George's County, Maryland",4052,321,209,70,185,112,996,902,183,800,94,441,352,197,184,89,728,630,560,229,98,1566,1336,1197,251,230
1400000US24033803509,"Census Tract 8035.09, Prince George's County, Maryland",3013,763,555,63,536,208,892,732,223,552,160,683,534,345,230,149,328,324,260,70,4,347,255,181,90,92
1400000US24033803512,"Census Tract 8035.12, Prince George's County, Maryland",6906,289,289,134,196,0,578,578,244,440,0,886,832,687,348,54,1250,1092,1012,282,158,3903,3610,3225,789,293
1400000US24033803513,"Census Tract 8035.13, Prince George's County, Maryland",4818,437,358,118,290,79,523,507,454,177,16,1001,890,725,214,111,672,623,373,277,49,2185,2028,1916,279,157
1400000US24033803514,"Census Tract 8035.14, Prince George's County, Maryland",4237,402,383,39,370,19,363,363,236,187,0,904,829,750,169,75,523,485,453,117,38,2045,1979,1979,96,66
1400000US24033803516,"Census Tract 8035.16, Prince George's County, Maryland",4862,297,274,168,134,23,535,501,139,401,34,416,416,351,108,0,394,394,320,130,0,3220,3180,3044,353,40
1400000US24033803519,"Census Tract 8035.19, Prince George's County, Maryland",5629,239,239,63,217,0,336,316,270,212,20,1055,1021,731,459,34,1350,1337,1211,230,13,2649,2537,2364,416,112
1400000US24033803520,"Census Tract 8035.20, Prince George's County, Maryland",4331,104,104,66,56,0,246,204,164,79,42,638,604,317,320,34,362,326,288,135,36,2981,2771,2625,620,210
1400000US24033803521,"Census Tract 8035.21, Prince George's County, Maryland",5884,316,293,266,158,23,331,263,204,153,68,931,851,587,425,80,508,462,416,202,46,3798,3737,3427,740,61
1400000US24033803522,"Census Tract 8035.22, Prince George's County, Maryland",3621,285,285,133,209,0,404,319,178,197,85,484,484,387,192,0,230,215,204,57,15,2218,2068,1878,355,150
1400000US24033803523,"Census Tract 8035.23, Prince George's County, Maryland",4021,383,383,56,372,0,204,179,146,69,25,503,456,315,206,47,192,178,170,86,14,2739,2670,2538,571,69
1400000US24033803524,"Census Tract 8035.24, Prince George's County, Maryland",4213,443,433,77,377,10,322,231,214,73,91,1298,1208,883,397,90,619,487,425,112,132,1531,1348,1147,272,183
1400000US24033803525,"Census Tract 8035.25, Prince George's County, Maryland",1994,154,136,40,116,18,428,331,271,108,97,589,564,419,172,25,346,346,303,74,0,477,411,403,46,66
1400000US24033803526,"Census Tract 8035.26, Prince George's County, Maryland",3246,108,102,66,67,6,301,263,250,60,38,798,724,674,68,74,578,556,380,245,22,1461,1417,1336,363,44
1400000US24033803527,"Census Tract 8035.27, Prince George's County, Maryland",3343,187,179,137,96,8,369,341,166,271,28,597,558,444,157,39,420,407,401,28,13,1770,1634,1490,284,136
1400000US24033803601,"Census Tract 8036.01, Prince George's County, Maryland",3901,235,181,71,141,54,494,415,199,269,79,931,821,675,347,110,562,499,396,151,63,1679,1596,1379,449,83
1400000US24033803602,"Census Tract 8036.02, Prince George's County, Maryland",2535,151,151,34,143,0,719,710,416,403,9,587,516,289,271,71,421,414,165,302,7,657,606,558,131,51
1400000US24033803605,"Census Tract 8036.05, Prince George's County, Maryland",7068,768,591,130,559,177,685,471,181,378,214,1339,1101,788,512,238,694,609,451,260,85,3582,3176,2679,688,406
1400000US24033803606,"Census Tract 8036.06, Prince George's County, Maryland",5294,334,266,81,215,68,512,388,257,243,124,1583,1146,769,465,437,378,378,258,224,0,2487,2296,2073,446,191
1400000US24033803607,"Census Tract 8036.07, Prince George's County, Maryland",3547,148,135,129,91,13,384,267,115,206,117,787,665,269,479,122,445,373,313,127,72,1783,1599,1385,448,184
1400000US24033803608,"Census Tract 8036.08, Prince George's County, Maryland",6170,311,289,185,213,22,1077,773,315,524,304,1453,1084,611,603,369,803,727,449,376,76,2526,2382,2180,475,144
1400000US24033803610,"Census Tract 8036.10, Prince George's County, Maryland",3673,362,283,78,220,79,832,673,314,413,159,725,526,485,108,199,332,311,279,129,21,1422,1192,960,406,230
1400000US24033803612,"Census Tract 8036.12, Prince George's County, Maryland",3309,245,217,107,125,28,935,843,440,443,92,1201,917,351,580,284,543,543,424,260,0,385,350,279,100,35
1400000US24033803613,"Census Tract 8036.13, Prince George's County, Maryland",5622,688,564,190,498,124,1055,887,605,344,168,1394,1022,652,491,372,943,768,624,209,175,1542,1189,835,407,353
1400000US24033803700,"Census Tract 8037, Prince George's County, Maryland",2771,247,207,28,207,40,517,397,220,204,120,645,579,281,343,66,488,422,333,113,66,874,745,580,241,129
1400000US24033803801,"Census Tract 8038.01, Prince George's County, Maryland",2471,107,68,34,44,39,278,199,90,129,79,622,546,356,254,76,747,533,415,149,214,717,611,444,215,106
1400000US24033803803,"Census Tract 8038.03, Prince George's County, Maryland",6216,601,579,145,473,22,1204,1083,303,876,121,1243,1036,640,429,207,1122,969,707,384,153,2046,1786,1346,595,260
1400000US24033803900,"Census Tract 8039, Prince George's County, Maryland",3826,117,90,37,59,27,753,498,244,306,255,748,398,154,253,350,941,673,366,349,268,1267,720,500,263,547
1400000US24033804001,"Census Tract 8040.01, Prince George's County, Maryland",4900,962,888,333,687,74,1944,1500,463,1176,444,497,497,363,160,0,517,403,266,178,114,980,868,793,111,112
1400000US24033804002,"Census Tract 8040.02, Prince George's County, Maryland",4300,355,290,119,221,65,757,569,298,322,188,1481,1127,381,789,354,306,273,233,72,33,1401,1100,833,369,301
1400000US24033804101,"Census Tract 8041.01, Prince George's County, Maryland",3491,363,330,291,66,33,445,407,219,233,38,925,785,258,591,140,396,396,325,111,0,1362,1256,1093,219,106
1400000US24033804102,"Census Tract 8041.02, Prince George's County, Maryland",5916,266,174,78,115,92,1096,800,479,398,296,1157,945,727,253,212,1123,1016,750,305,107,2274,2049,1606,584,225
1400000US24033804200,"Census Tract 8042, Prince George's County, Maryland",3114,73,53,26,44,20,106,96,78,74,10,376,340,203,145,36,541,499,388,156,42,2018,1952,1804,315,66
1400000US24033804300,"Census Tract 8043, Prince George's County, Maryland",3343,578,373,108,312,205,829,768,393,439,61,613,482,305,229,131,632,421,274,253,211,691,500,327,187,191
1400000US24033804400,"Census Tract 8044, Prince George's County, Maryland",2782,248,225,71,185,23,495,422,163,318,73,421,362,256,127,59,589,449,323,169,140,1029,775,491,335,254
1400000US24033804600,"Census Tract 8046, Prince George's County, Maryland",3154,216,167,19,148,49,325,220,76,159,105,399,370,286,139,29,795,568,293,296,227,1419,1184,847,432,235
1400000US24033804700,"Census Tract 8047, Prince George's County, Maryland",3349,201,141,49,92,60,485,456,192,309,29,486,370,277,136,116,319,272,234,76,47,1858,1723,1569,295,135
1400000US24033804801,"Census Tract 8048.01, Prince George's County, Maryland",2535,621,476,205,370,145,960,640,309,343,320,529,520,394,139,9,231,227,199,58,4,194,194,142,83,0
1400000US24033804802,"Census Tract 8048.02, Prince George's County, Maryland",3077,263,123,54,103,140,793,579,204,425,214,1368,962,574,432,406,560,505,334,221,55,93,78,78,0,15
1400000US24033804900,"Census Tract 8049, Prince George's County, Maryland",3514,217,200,164,149,17,548,425,281,192,123,644,459,405,65,185,965,824,536,377,141,1140,924,854,231,216
1400000US24033805000,"Census Tract 8050, Prince George's County, Maryland",5552,293,276,150,218,17,1665,1399,818,874,266,939,614,473,247,325,1366,1285,654,693,81,1289,1122,787,439,167
1400000US24033805101,"Census Tract 8051.01, Prince George's County, Maryland",4126,337,235,70,172,102,1242,860,294,604,382,775,573,319,301,202,774,570,377,193,204,998,867,478,405,131
1400000US24033805201,"Census Tract 8052.01, Prince George's County, Maryland",5025,616,373,146,275,243,1476,894,469,563,582,550,411,296,168,139,662,376,289,157,286,1721,1389,1021,558,332
1400000US24033805202,"Census Tract 8052.02, Prince George's County, Maryland",3772,667,487,58,436,180,520,416,213,249,104,1262,989,588,472,273,527,421,291,187,106,796,558,377,200,238
1400000US24033805500,"Census Tract 8055, Prince George's County, Maryland",3897,737,403,117,295,334,643,400,123,329,243,731,406,117,313,325,518,294,127,188,224,1268,1024,799,261,244
1400000US24033805601,"Census Tract 8056.01, Prince George's County, Maryland",6620,799,409,52,382,390,2350,1263,221,1042,1087,1566,626,176,450,940,1011,357,111,246,654,894,225,90,149,669
1400000US24033805602,"Census Tract 8056.02, Prince George's County, Maryland",5443,174,64,41,44,110,869,479,47,470,390,1348,557,84,473,791,1577,572,156,437,1005,1475,438,0,438,1037
1400000US24033805700,"Census Tract 8057, Prince George's County, Maryland",6021,739,503,225,313,236,962,717,271,487,245,1491,965,386,595,526,1118,635,468,199,483,1711,1061,688,402,650
1400000US24033805801,"Census Tract 8058.01, Prince George's County, Maryland",4734,122,87,38,72,35,690,478,209,311,212,791,665,368,304,126,412,264,114,164,148,2719,2225,1955,467,494
1400000US24033805802,"Census Tract 8058.02, Prince George's County, Maryland",4152,481,333,77,260,148,740,522,234,426,218,771,588,330,284,183,688,396,249,174,292,1472,842,668,247,630
1400000US24033805904,"Census Tract 8059.04, Prince George's County, Maryland",3130,155,118,64,92,37,376,293,131,205,83,765,587,452,259,178,385,287,225,87,98,1449,1117,861,364,332
1400000US24033805906,"Census Tract 8059.06, Prince George's County, Maryland",3299,491,446,149,342,45,817,517,348,185,300,648,337,229,116,311,888,545,376,169,343,455,396,338,80,59
1400000US24033805907,"Census Tract 8059.07, Prince George's County, Maryland",4068,473,332,93,253,141,760,491,230,268,269,1482,929,540,419,553,709,478,334,157,231,644,463,409,54,181
1400000US24033805908,"Census Tract 8059.08, Prince George's County, Maryland",2198,296,187,56,141,109,460,363,216,171,97,509,377,314,101,132,437,258,197,79,179,496,344,229,149,152
1400000US24033805909,"Census Tract 8059.09, Prince George's County, Maryland",4913,513,465,380,102,48,1118,857,465,418,261,1428,1239,765,534,189,680,546,497,102,134,1174,1039,954,154,135
1400000US24033806000,"Census Tract 8060, Prince George's County, Maryland",5085,505,376,63,331,129,911,594,237,489,317,1131,844,569,358,287,1272,950,830,167,322,1266,1072,982,150,194
1400000US24033806100,"Census Tract 8061, Prince George's County, Maryland",4215,546,366,40,356,180,470,407,181,268,63,878,808,428,417,70,894,793,571,276,101,1427,1357,1276,207,70
1400000US24033806200,"Census Tract 8062, Prince George's County, Maryland",3911,294,288,129,202,6,766,638,445,359,128,567,552,479,207,15,528,498,421,128,30,1756,1668,1596,167,88
1400000US24033806300,"Census Tract 8063, Prince George's County, Maryland",2503,241,211,105,112,30,369,316,187,153,53,644,465,333,163,179,435,305,222,86,130,814,759,672,126,55
1400000US24033806400,"Census Tract 8064, Prince George's County, Maryland",3508,123,94,77,40,29,337,307,227,204,30,325,325,299,66,0,324,324,313,60,0,2399,2325,2220,398,74
1400000US24033806501,"Census Tract 8065.01, Prince George's County, Maryland",5435,566,426,90,372,140,1169,690,122,599,479,1332,564,202,440,768,543,397,263,149,146,1825,1333,1221,212,492
1400000US24033806601,"Census Tract 8066.01, Prince George's County, Maryland",4284,688,491,204,364,197,1144,531,302,277,613,833,605,325,314,228,407,234,169,73,173,1212,810,419,479,402
1400000US24033806602,"Census Tract 8066.02, Prince George's County, Maryland",5678,564,481,29,458,83,810,566,257,344,244,1394,1129,667,570,265,516,371,273,138,145,2394,1879,949,1058,515
1400000US24033806706,"Census Tract 8067.06, Prince George's County, Maryland",3402,316,197,161,85,119,645,527,314,330,118,677,618,462,258,59,323,281,243,64,42,1441,1062,1007,211,379
1400000US24033806708,"Census Tract 8067.08, Prince George's County, Maryland",4266,360,299,169,209,61,669,651,589,181,18,732,526,492,103,206,672,672,602,114,0,1833,1789,1645,449,44
1400000US24033806710,"Census Tract 8067.10, Prince George's County, Maryland",5286,379,302,55,286,77,601,472,363,284,129,839,730,670,100,109,927,831,707,177,96,2540,2304,2217,197,236
1400000US24033806711,"Census Tract 8067.11, Prince George's County, Maryland",4969,474,403,177,259,71,911,808,583,352,103,977,922,659,328,55,1067,910,737,286,157,1540,1297,1062,346,243
1400000US24033806712,"Census Tract 8067.12, Prince George's County, Maryland",3336,122,122,69,122,0,361,230,124,154,131,490,479,417,115,11,644,628,511,142,16,1719,1666,1613,126,53
1400000US24033806713,"Census Tract 8067.13, Prince George's County, Maryland",4122,377,316,58,258,61,1155,891,445,466,264,1359,1205,832,447,154,437,421,379,86,16,794,698,566,170,96
1400000US24033806714,"Census Tract 8067.14, Prince George's County, Maryland",4024,546,515,115,441,31,1049,725,344,405,324,1127,705,426,296,422,514,382,225,172,132,788,469,350,157,319
1400000US24033806800,"Census Tract 8068, Prince George's County, Maryland",4178,134,110,61,88,24,333,316,196,176,17,915,707,543,214,208,529,508,434,124,21,2267,2043,1767,563,224
1400000US24033806900,"Census Tract 8069, Prince George's County, Maryland",5547,571,454,91,399,117,311,193,102,109,118,1295,1116,636,538,179,592,566,510,174,26,2778,2574,2465,274,204
1400000US24033807000,"Census Tract 8070, Prince George's County, Maryland",6910,1761,1537,1089,585,224,1340,1128,1032,242,212,1231,891,749,211,340,154,154,144,38,0,2424,2283,2074,331,141
1400000US24033807102,"Census Tract 8071.02, Prince George's County, Maryland",2484,330,264,188,90,66,283,263,181,152,20,336,283,233,72,53,242,228,221,45,14,1293,1170,1108,198,123
1400000US24033807200,"Census Tract 8072, Prince George's County, Maryland",2848,1363,1239,1229,18,124,251,227,227,10,24,662,641,641,52,21,189,189,178,49,0,383,383,359,80,0
1400000US24033807301,"Census Tract 8073.01, Prince George's County, Maryland",3423,508,428,235,218,80,716,584,512,151,132,561,561,466,138,0,397,322,259,100,75,1241,1193,1065,285,48
1400000US24033807304,"Census Tract 8073.04, Prince George's County, Maryland",2089,33,27,17,15,6,341,248,134,143,93,156,145,68,97,11,303,286,235,114,17,1256,1104,921,316,152
1400000US24033807305,"Census Tract 8073.05, Prince George's County, Maryland",3539,85,85,18,74,0,502,436,209,318,66,846,713,360,436,133,323,183,83,117,140,1783,1732,1371,544,51
1400000US24033807404,"Census Tract 8074.04, Prince George's County, Maryland",5709,265,222,149,126,43,620,597,283,363,23,1234,911,826,217,323,718,557,394,203,161,2872,2771,2441,484,101
1400000US24033807405,"Census Tract 8074.05, Prince George's County, Maryland",5316,550,446,272,243,104,330,252,141,157,78,680,550,437,202,130,907,907,746,297,0,2849,2593,2407,461,256
1400000US24033807407,"Census Tract 8074.07, Prince George's County, Maryland",5966,218,218,126,197,0,1037,955,669,330,82,885,761,559,242,124,989,917,838,152,72,2837,2666,2430,443,171
1400000US24033807408,"Census Tract 8074.08, Prince George's County, Maryland",5955,336,336,181,218,0,528,528,295,272,0,1074,1030,923,186,44,898,684,618,282,214,3119,2862,2751,363,257
1400000US24033807409,"Census Tract 8074.09, Prince George's County, Maryland",4208,428,311,38,311,117,729,491,265,256,238,840,713,498,255,127,880,735,693,133,145,1331,1039,862,229,292
1400000US24033807410,"Census Tract 8074.10, Prince George's County, Maryland",4121,749,578,117,505,171,602,462,363,160,140,755,703,493,304,52,748,688,513,212,60,1267,1161,897,330,106
1400000US24035810100,"Census Tract 8101, Queen Anne's County, Maryland",3070,120,120,42,120,0,885,769,271,637,116,722,638,531,286,84,446,446,383,141,0,897,882,843,169,15
1400000US24035810200,"Census Tract 8102, Queen Anne's County, Maryland",2750,219,193,83,154,26,548,462,282,366,86,614,530,426,173,84,278,261,236,69,17,1091,1046,878,217,45
1400000US24035810300,"Census Tract 8103, Queen Anne's County, Maryland",4413,485,470,177,430,15,963,877,529,517,86,860,784,529,386,76,652,646,543,224,6,1453,1447,1327,284,6
1400000US24035810400,"Census Tract 8104, Queen Anne's County, Maryland",5817,201,188,99,188,13,333,296,244,156,37,807,755,618,300,52,731,731,601,197,0,3745,3629,3366,570,116
1400000US24035810500,"Census Tract 8105, Queen Anne's County, Maryland",5381,244,224,166,89,20,719,668,416,437,51,633,564,430,264,69,637,577,511,233,60,3148,3096,3073,318,52
1400000US24035810600,"Census Tract 8106, Queen Anne's County, Maryland",4957,371,350,178,270,21,403,403,296,270,0,641,641,607,133,0,340,281,250,46,59,3202,3023,2484,1055,179
1400000US24035810700,"Census Tract 8107, Queen Anne's County, Maryland",4024,495,471,117,385,24,661,639,97,573,22,479,469,444,136,10,521,500,427,185,21,1868,1804,1690,275,64
1400000US24035810800,"Census Tract 8108, Queen Anne's County, Maryland",5639,292,292,112,223,0,413,363,293,288,50,711,648,523,322,63,779,779,768,98,0,3444,3318,2968,583,126
1400000US24035810901,"Census Tract 8109.01, Queen Anne's County, Maryland",4978,123,123,82,86,0,467,440,394,225,27,479,462,394,163,17,616,587,510,191,29,3293,3281,3076,522,12
1400000US24035810902,"Census Tract 8109.02, Queen Anne's County, Maryland",2938,108,101,85,65,7,326,301,186,222,25,423,388,327,102,35,589,589,551,127,0,1492,1492,1413,222,0
1400000US24035811000,"Census Tract 8110, Queen Anne's County, Maryland",4503,423,404,197,308,19,465,437,253,268,28,899,504,420,209,395,396,378,335,83,18,2320,2296,2132,362,24
1400000US24035990000,"Census Tract 9900, Queen Anne's County, Maryland",0,0,0,0,0,0,0,0,0,0,0,0,0,0,0,0,0,0,0,0,0,0,0,0,0,0
1400000US24035990100,"Census Tract 9901, Queen Anne's County, Maryland",0,0,0,0,0,0,0,0,0,0,0,0,0,0,0,0,0,0,0,0,0,0,0,0,0,0
1400000US24035990200,"Census Tract 9902, Queen Anne's County, Maryland",0,0,0,0,0,0,0,0,0,0,0,0,0,0,0,0,0,0,0,0,0,0,0,0,0,0
1400000US24037875000,"Census Tract 8750, St. Mary's County, Maryland",6454,556,556,272,312,0,592,578,338,396,14,744,708,644,206,36,896,896,896,163,0,3666,3594,3375,430,72
1400000US24037875100,"Census Tract 8751, St. Mary's County, Maryland",5372,176,166,134,92,10,677,567,321,364,110,519,455,362,224,64,1306,1168,970,336,138,2694,2136,2088,242,558
1400000US24037875201,"Census Tract 8752.01, St. Mary's County, Maryland",5025,422,401,242,293,21,651,643,401,312,8,523,382,315,126,141,592,586,514,178,6,2837,2785,2738,232,52
1400000US24037875202,"Census Tract 8752.02, St. Mary's County, Maryland",6112,452,323,116,249,129,413,413,339,147,0,1268,958,659,387,310,714,714,687,119,0,3265,3216,3112,290,49
1400000US24037875300,"Census Tract 8753, St. Mary's County, Maryland",2958,486,447,173,362,39,578,565,237,399,13,546,534,503,191,12,521,503,477,116,18,827,789,711,160,38
1400000US24037875400,"Census Tract 8754, St. Mary's County, Maryland",6391,609,591,230,528,18,760,692,398,453,68,636,636,621,253,0,607,566,566,90,41,3779,3722,3616,477,57
1400000US24037875500,"Census Tract 8755, St. Mary's County, Maryland",10320,553,378,165,307,175,962,861,641,487,101,1506,1395,1206,331,111,1417,1402,1282,171,15,5882,5784,5614,548,98
1400000US24037875600,"Census Tract 8756, St. Mary's County, Maryland",8498,354,354,181,277,0,942,929,657,439,13,793,741,681,133,52,1680,1478,1436,186,202,4729,4650,4412,638,79
1400000US24037875700,"Census Tract 8757, St. Mary's County, Maryland",7299,455,442,321,349,13,768,733,417,626,35,750,750,647,343,0,981,947,749,487,34,4345,4145,3979,596,200
1400000US24037875801,"Census Tract 8758.01, St. Mary's County, Maryland",1066,72,72,72,0,0,326,326,326,2,0,331,331,325,13,0,181,181,181,8,0,156,156,150,14,0
1400000US24037875802,"Census Tract 8758.02, St. Mary's County, Maryland",4235,81,81,48,60,0,591,525,245,387,66,407,385,335,156,22,762,749,705,202,13,2394,2219,2093,401,175
1400000US24037875901,"Census Tract 8759.01, St. Mary's County, Maryland",6693,397,319,96,281,78,550,452,337,252,98,1273,1259,1091,236,14,1051,988,928,113,63,3422,3422,3082,506,0
1400000US24037875902,"Census Tract 8759.02, St. Mary's County, Maryland",8613,1221,1207,460,878,14,1862,1697,968,904,165,1072,905,539,485,167,1192,837,685,175,355,3266,3134,2736,815,132
1400000US24037876001,"Census Tract 8760.01, St. Mary's County, Maryland",4957,946,909,122,835,37,1124,999,446,674,125,638,568,558,204,70,597,587,548,150,10,1652,1499,1252,385,153
1400000US24037876002,"Census Tract 8760.02, St. Mary's County, Maryland",9484,1182,856,451,470,326,992,791,452,455,201,1600,1585,1435,260,15,1693,1467,1211,398,226,4017,3973,3788,446,44
1400000US24037876100,"Census Tract 8761, St. Mary's County, Maryland",7689,555,555,117,498,0,825,751,369,517,74,874,768,635,410,106,850,850,779,210,0,4585,4440,4072,855,145
1400000US24037876200,"Census Tract 8762, St. Mary's County, Maryland",5246,498,409,235,210,89,627,627,520,433,0,565,545,508,138,20,644,644,451,339,0,2912,2825,2447,667,87
1400000US24037990000,"Census Tract 9900, St. Mary's County, Maryland",0,0,0,0,0,0,0,0,0,0,0,0,0,0,0,0,0,0,0,0,0,0,0,0,0,0
1400000US24039930101,"Census Tract 9301.01, Somerset County, Maryland",4956,1898,1807,871,1076,91,1228,1034,279,876,194,665,647,418,353,18,745,557,348,209,188,420,362,264,146,58
1400000US24039930102,"Census Tract 9301.02, Somerset County, Maryland",3960,858,767,59,759,91,1057,1029,563,573,28,597,547,332,371,50,651,581,524,144,70,797,776,740,165,21
1400000US24039930200,"Census Tract 9302, Somerset County, Maryland",1698,560,501,155,444,59,308,304,252,159,4,436,339,237,204,97,124,106,89,53,18,270,263,260,41,7
1400000US24039930300,"Census Tract 9303, Somerset County, Maryland",2077,279,261,133,239,18,549,362,195,220,187,394,385,377,65,9,146,146,103,97,0,709,627,554,172,82
1400000US24039930500,"Census Tract 9305, Somerset County, Maryland",4098,581,555,218,459,26,1009,992,508,686,17,1038,914,788,272,124,706,694,666,173,12,764,692,528,212,72
1400000US24039930600,"Census Tract 9306, Somerset County, Maryland",2933,1004,910,154,821,94,968,812,441,501,156,404,364,265,169,40,206,206,119,134,0,351,351,302,99,0
1400000US24039980400,"Census Tract 9804, Somerset County, Maryland",44,5,5,0,5,0,13,13,13,8,0,8,8,8,8,0,0,0,0,0,0,18,18,18,9,0
1400000US24039990100,"Census Tract 9901, Somerset County, Maryland",0,0,0,0,0,0,0,0,0,0,0,0,0,0,0,0,0,0,0,0,0,0,0,0,0,0
1400000US24041960100,"Census Tract 9601, Talbot County, Maryland",4268,273,273,170,153,0,618,546,364,366,72,599,570,368,271,29,685,681,563,294,4,2093,2075,1782,474,18
1400000US24041960201,"Census Tract 9602.01, Talbot County, Maryland",3940,516,446,253,314,70,460,426,330,283,34,327,327,240,228,0,301,301,259,245,0,2336,2254,2099,674,82
1400000US24041960300,"Census Tract 9603, Talbot County, Maryland",3765,793,768,143,718,25,1415,1263,768,775,152,575,514,441,241,61,279,272,252,80,7,703,624,558,156,79
1400000US24041960400,"Census Tract 9604, Talbot County, Maryland",5068,955,810,571,400,145,1926,1540,860,1061,386,831,809,668,303,22,630,619,580,173,11,726,726,661,145,0
1400000US24041960501,"Census Tract 9605.01, Talbot County, Maryland",4884,471,366,142,307,105,739,720,431,466,19,633,599,559,220,34,845,827,770,251,18,2196,2024,1896,262,172
1400000US24041960502,"Census Tract 9605.02, Talbot County, Maryland",3931,623,543,222,455,80,411,390,286,266,21,849,836,749,415,13,724,724,657,259,0,1324,1315,1252,339,9
1400000US24041960600,"Census Tract 9606, Talbot County, Maryland",1639,119,97,34,80,22,256,256,163,170,0,277,268,226,128,9,283,277,247,99,6,704,704,641,247,0
1400000US24041960700,"Census Tract 9607, Talbot County, Maryland",3344,415,352,257,207,63,445,432,308,341,13,610,558,477,305,52,493,482,468,158,11,1381,1341,1257,624,40
1400000US24041960800,"Census Tract 9608, Talbot County, Maryland",1939,287,252,89,230,35,272,262,224,124,10,366,252,120,214,114,412,384,384,112,28,602,596,487,222,6
1400000US24041960900,"Census Tract 9609, Talbot County, Maryland",4242,533,469,188,409,64,499,467,330,316,32,862,790,658,294,72,626,624,542,226,2,1722,1672,1570,509,50
1400000US24041990000,"Census Tract 9900, Talbot County, Maryland",0,0,0,0,0,0,0,0,0,0,0,0,0,0,0,0,0,0,0,0,0,0,0,0,0,0
1400000US24043000100,"Census Tract 1, Washington County, Maryland",3245,344,344,155,318,0,519,482,324,233,37,771,726,668,158,45,606,606,567,71,0,1005,994,947,131,11
1400000US24043000200,"Census Tract 2, Washington County, Maryland",3383,597,485,312,269,112,664,664,504,378,0,783,715,600,281,68,562,562,510,86,0,777,769,733,169,8
1400000US24043000301,"Census Tract 3.01, Washington County, Maryland",3137,1028,930,134,835,98,636,601,345,360,35,569,529,456,186,40,455,338,253,124,117,449,439,354,93,10
1400000US24043000302,"Census Tract 3.02, Washington County, Maryland",2770,504,327,93,294,177,1030,987,222,852,43,471,471,261,248,0,452,408,311,97,44,313,273,236,58,40
1400000US24043000400,"Census Tract 4, Washington County, Maryland",1494,737,644,141,589,93,412,363,169,257,49,125,112,62,52,13,128,110,64,54,18,92,92,91,22,0
1400000US24043000500,"Census Tract 5, Washington County, Maryland",5571,1499,1364,289,1230,135,1026,960,641,483,66,1691,1509,1307,403,182,832,755,632,123,77,523,476,267,238,47
1400000US24043000601,"Census Tract 6.01, Washington County, Maryland",2361,486,442,120,390,44,652,575,172,439,77,295,266,231,86,29,453,366,291,82,87,475,407,367,64,68
1400000US24043000602,"Census Tract 6.02, Washington County, Maryland",3139,529,499,188,487,30,859,790,524,534,69,465,451,313,256,14,880,880,785,207,0,406,406,385,126,0
1400000US24043000700,"Census Tract 7, Washington County, Maryland",2941,1220,1045,173,986,175,424,359,175,271,65,709,592,383,219,117,454,419,274,145,35,134,73,23,50,61
1400000US24043000800,"Census Tract 8, Washington County, Maryland",3283,823,771,190,765,52,901,869,353,613,32,601,569,503,137,32,539,472,372,140,67,419,411,403,26,8
1400000US24043000900,"Census Tract 9, Washington County, Maryland",3302,1426,1145,286,983,281,713,597,264,413,116,526,464,375,132,62,245,226,206,28,19,392,153,153,8,239
1400000US24043001001,"Census Tract 10.01, Washington County, Maryland",4985,1563,1336,306,1221,227,925,830,687,416,95,776,760,695,194,16,727,727,693,202,0,994,933,872,189,61
1400000US24043001002,"Census Tract 10.02, Washington County, Maryland",3939,547,475,127,409,72,500,492,360,299,8,743,737,693,136,6,709,693,621,194,16,1440,1373,1273,280,67
1400000US24043010100,"Census Tract 101, Washington County, Maryland",997,77,77,16,77,0,295,271,129,142,24,247,216,198,65,31,162,154,140,37,8,216,207,177,49,9
1400000US24043010200,"Census Tract 102, Washington County, Maryland",4563,277,235,83,224,42,813,782,491,498,31,803,689,586,254,114,719,678,571,184,41,1951,1643,1559,174,308
1400000US24043010300,"Census Tract 103, Washington County, Maryland",7331,532,482,302,300,50,1053,888,742,530,165,1208,1086,698,678,122,947,808,779,158,139,3591,3506,3055,894,85
1400000US24043010400,"Census Tract 104, Washington County, Maryland",8184,1122,1045,282,986,77,1157,1042,676,705,115,1441,1441,1054,638,0,1661,1661,1131,684,0,2803,2493,2072,592,310
1400000US24043010500,"Census Tract 105, Washington County, Maryland",6234,853,815,291,732,38,1869,1565,1016,934,304,1184,962,916,310,222,765,695,617,90,70,1563,1332,1273,143,231
1400000US24043010600,"Census Tract 106, Washington County, Maryland",5284,453,429,167,359,24,1065,956,602,617,109,1590,1542,1259,565,48,1024,971,874,214,53,1152,1152,1109,146,0
1400000US24043010700,"Census Tract 107, Washington County, Maryland",3287,500,483,142,426,17,978,897,572,563,81,788,767,595,316,21,395,389,364,116,6,626,563,548,163,63
1400000US24043010801,"Census Tract 108.01, Washington County, Maryland",4288,647,599,305,497,48,768,630,506,427,138,419,412,317,174,7,940,911,862,171,29,1514,1514,1280,338,0
1400000US24043010802,"Census Tract 108.02, Washington County, Maryland",2701,394,389,117,330,5,543,478,325,268,65,411,348,261,200,63,352,336,324,65,16,1001,980,924,124,21
1400000US24043010900,"Census Tract 109, Washington County, Maryland",8400,348,329,130,287,19,1103,1032,920,378,71,1924,1718,1414,722,206,1205,1189,1088,342,16,3820,3686,3467,844,134
1400000US24043011000,"Census Tract 110, Washington County, Maryland",0,0,0,0,0,0,0,0,0,0,0,0,0,0,0,0,0,0,0,0,0,0,0,0,0,0
1400000US24043011100,"Census Tract 111, Washington County, Maryland",6101,997,993,214,902,4,1354,1165,782,693,189,1477,1424,1247,497,53,718,718,532,270,0,1555,1490,1422,157,65
1400000US24043011201,"Census Tract 112.01, Washington County, Maryland",9370,867,821,505,709,46,1623,1472,967,855,151,1926,1899,1322,848,27,1249,1205,1087,245,44,3705,3593,3472,346,112
1400000US24043011202,"Census Tract 112.02, Washington County, Maryland",4499,433,372,190,335,61,1183,997,554,705,186,642,619,566,113,23,788,755,687,239,33,1453,1303,1289,110,150
1400000US24043011301,"Census Tract 113.01, Washington County, Maryland",4856,348,348,132,294,0,741,704,452,373,37,855,815,704,236,40,785,739,701,110,46,2127,2075,1954,219,52
1400000US24043011302,"Census Tract 113.02, Washington County, Maryland",4025,238,213,86,160,25,450,433,223,284,17,410,333,324,139,77,644,617,460,271,27,2283,2246,2068,451,37
1400000US24043011400,"Census Tract 114, Washington County, Maryland",5606,500,489,83,489,11,1419,1334,781,820,85,1086,1086,940,308,0,543,543,521,231,0,2058,2028,1902,303,30
1400000US24043011500,"Census Tract 115, Washington County, Maryland",8140,647,560,357,319,87,757,720,508,375,37,1335,1300,919,572,35,1107,1059,864,303,48,4294,4276,3811,866,18
1400000US24043011600,"Census Tract 116, Washington County, Maryland",3046,239,229,124,170,10,479,429,270,288,50,545,459,400,153,86,518,511,497,57,7,1265,1256,1128,233,9
1400000US24045000100,"Census Tract 1, Wicomico County, Maryland",5875,1553,1331,180,1195,222,2041,1621,794,995,420,963,845,320,611,118,509,499,429,90,10,809,676,365,397,133
1400000US24045000200,"Census Tract 2, Wicomico County, Maryland",1611,430,278,72,257,152,170,140,104,78,30,346,299,229,113,47,289,283,206,161,6,376,376,347,108,0
1400000US24045000300,"Census Tract 3, Wicomico County, Maryland",1449,444,370,57,333,74,494,463,137,355,31,202,147,22,125,55,182,139,14,125,43,127,127,83,49,0
1400000US24045000400,"Census Tract 4, Wicomico County, Maryland",4112,1162,1006,595,477,156,693,615,364,329,78,1068,874,468,547,194,485,465,414,120,20,704,678,662,64,26
1400000US24045000500,"Census Tract 5, Wicomico County, Maryland",3236,572,500,134,408,72,1030,928,658,275,102,869,825,555,332,44,244,200,184,44,44,521,509,450,118,12
1400000US24045010101,"Census Tract 101.01, Wicomico County, Maryland",6034,1133,1032,233,916,101,1400,1266,908,526,134,1040,1040,986,280,0,999,977,906,340,22,1462,1447,1399,309,15
1400000US24045010102,"Census Tract 101.02, Wicomico County, Maryland",3663,817,776,169,679,41,706,696,417,453,10,633,623,389,362,10,915,725,652,120,190,592,585,549,135,7
1400000US24045010200,"Census Tract 102, Wicomico County, Maryland",5030,1322,1281,265,1228,41,1388,1283,584,866,105,1171,1017,580,574,154,521,454,369,185,67,628,478,416,200,150
1400000US24045010300,"Census Tract 103, Wicomico County, Maryland",8453,1038,1038,60,1038,0,1089,917,612,637,172,665,665,540,277,0,864,775,556,274,89,4797,4598,4149,1001,199
1400000US24045010400,"Census Tract 104, Wicomico County, Maryland",5145,873,803,321,639,70,1031,823,624,443,208,805,740,342,490,65,788,788,700,136,0,1648,1550,1409,286,98
1400000US24045010501,"Census Tract 105.01, Wicomico County, Maryland",5633,691,645,306,395,46,946,857,361,616,89,972,894,728,329,78,1488,1305,907,524,183,1536,1412,1313,181,124
1400000US24045010502,"Census Tract 105.02, Wicomico County, Maryland",8361,2407,2329,1416,1013,78,2610,2476,1944,747,134,1726,1620,1270,634,106,638,616,418,267,22,980,885,744,240,95
1400000US24045010603,"Census Tract 106.03, Wicomico County, Maryland",7385,917,805,373,585,112,2194,1924,1183,1176,270,1118,1057,983,219,61,765,713,653,201,52,2391,2344,2168,418,47
1400000US24045010604,"Census Tract 106.04, Wicomico County, Maryland",4665,711,650,117,592,61,1124,976,492,716,148,1171,1085,941,259,86,1043,944,760,305,99,616,567,543,47,49
1400000US24045010605,"Census Tract 106.05, Wicomico County, Maryland",4146,266,244,104,217,22,604,496,361,315,108,735,683,593,246,52,733,724,613,193,9,1808,1772,1727,209,36
1400000US24045010606,"Census Tract 106.06, Wicomico County, Maryland",4454,236,201,92,164,35,1099,1075,679,676,24,967,718,515,290,249,938,908,781,257,30,1214,1143,1066,187,71
1400000US24045010701,"Census Tract 107.01, Wicomico County, Maryland",4195,589,542,160,498,47,894,813,533,489,81,988,887,567,485,101,662,633,556,114,29,1062,1042,957,196,20
1400000US24045010702,"Census Tract 107.02, Wicomico County, Maryland",7721,1321,1041,355,889,280,1286,1091,729,603,195,1355,1259,1070,305,96,1284,944,758,283,340,2475,2356,2106,469,119
1400000US24045010800,"Census Tract 108, Wicomico County, Maryland",6680,333,319,132,265,14,1316,1244,520,913,72,1179,1082,640,719,97,905,722,622,263,183,2947,2909,2783,484,38
1400000US24047950000,"Census Tract 9500, Worcester County, Maryland",1622,259,216,88,156,43,274,265,202,181,9,215,194,182,104,21,223,187,145,76,36,651,587,491,132,64
1400000US24047950100,"Census Tract 9501, Worcester County, Maryland",2260,123,123,52,110,0,330,312,223,202,18,435,410,378,116,25,359,359,329,62,0,1013,948,831,358,65
1400000US24047950300,"Census Tract 9503, Worcester County, Maryland",3166,398,366,252,239,32,807,745,557,490,62,849,797,653,481,52,338,290,290,97,48,774,763,677,287,11
1400000US24047950400,"Census Tract 9504, Worcester County, Maryland",2899,205,194,94,173,11,543,513,326,295,30,618,577,423,328,41,453,417,380,125,36,1080,1080,1033,169,0
1400000US24047950600,"Census Tract 9506, Worcester County, Maryland",2949,299,252,75,225,47,488,480,399,322,8,393,393,237,307,0,664,587,541,191,77,1105,1017,968,329,88
1400000US24047950700,"Census Tract 9507, Worcester County, Maryland",2598,271,262,129,199,9,405,399,292,205,6,512,453,372,216,59,274,274,256,137,0,1136,1128,1104,297,8
1400000US24047950800,"Census Tract 9508, Worcester County, Maryland",5045,503,503,231,384,0,837,644,374,357,193,757,677,632,82,80,730,714,659,142,16,2218,2113,1904,514,105
1400000US24047950900,"Census Tract 9509, Worcester County, Maryland",1788,210,179,26,164,31,308,293,219,178,15,256,252,197,121,4,293,211,203,89,82,721,721,633,175,0
1400000US24047951000,"Census Tract 9510, Worcester County, Maryland",4422,814,804,219,691,10,895,806,472,582,89,729,712,476,353,17,958,892,656,265,66,1026,959,931,140,67
1400000US24047951100,"Census Tract 9511, Worcester County, Maryland",6722,573,573,400,395,0,1361,1096,711,897,265,1445,1354,1061,884,91,721,721,622,623,0,2622,2579,2512,556,43
1400000US24047951200,"Census Tract 9512, Worcester County, Maryland",3394,204,204,121,153,0,706,592,324,407,114,604,564,385,262,40,954,860,828,166,94,926,908,860,154,18
1400000US24047951300,"Census Tract 9513, Worcester County, Maryland",2393,591,550,98,502,41,866,719,353,529,147,541,510,426,205,31,57,57,53,18,0,338,305,305,60,33
1400000US24047951400,"Census Tract 9514, Worcester County, Maryland",3611,603,553,238,439,50,874,821,550,416,53,664,542,371,284,122,497,497,460,171,0,973,924,848,232,49
1400000US24047951500,"Census Tract 9515, Worcester County, Maryland",4542,1475,1313,214,1274,162,1248,1133,643,660,115,618,578,349,391,40,436,420,337,104,16,765,690,620,143,75
1400000US24047951700,"Census Tract 9517, Worcester County, Maryland",3332,456,361,188,266,95,475,361,297,171,114,794,683,527,424,111,516,472,241,325,44,1091,1008,914,264,83
1400000US24047980000,"Census Tract 9800, Worcester County, Maryland",0,0,0,0,0,0,0,0,0,0,0,0,0,0,0,0,0,0,0,0,0,0,0,0,0,0
1400000US24047990000,"Census Tract 9900, Worcester County, Maryland",0,0,0,0,0,0,0,0,0,0,0,0,0,0,0,0,0,0,0,0,0,0,0,0,0,0
1400000US24510010100,"Census Tract 101, Baltimore city, Maryland",3030,179,154,73,134,25,465,441,343,212,24,239,239,239,36,0,401,375,294,120,26,1746,1742,1676,152,4
1400000US24510010200,"Census Tract 102, Baltimore city, Maryland",3145,136,136,35,136,0,288,246,164,160,42,293,279,262,64,14,461,445,445,25,16,1967,1945,1945,28,22
1400000US24510010300,"Census Tract 103, Baltimore city, Maryland",2537,85,85,56,49,0,157,147,85,84,10,168,128,93,35,40,362,357,357,8,5,1765,1722,1634,100,43
1400000US24510010400,"Census Tract 104, Baltimore city, Maryland",2561,129,129,49,98,0,266,197,156,139,69,258,258,246,19,0,299,275,275,14,24,1609,1547,1509,76,62
1400000US24510010500,"Census Tract 105, Baltimore city, Maryland",1686,116,86,54,55,30,113,103,90,38,10,179,179,174,15,0,381,346,346,4,35,897,832,819,51,65
1400000US24510020100,"Census Tract 201, Baltimore city, Maryland",1874,184,150,52,115,34,196,188,133,73,8,346,336,295,55,10,234,224,201,28,10,914,782,763,41,132
1400000US24510020200,"Census Tract 202, Baltimore city, Maryland",1854,199,157,76,100,42,265,210,146,78,55,301,288,244,61,13,163,163,157,6,0,926,883,877,48,43
1400000US24510020300,"Census Tract 203, Baltimore city, Maryland",3768,364,331,146,185,33,310,310,220,104,0,522,522,484,38,0,374,374,351,36,0,2198,2170,2090,111,28
1400000US24510030100,"Census Tract 301, Baltimore city, Maryland",3268,1230,882,208,832,348,1031,1031,520,567,0,310,310,30,280,0,434,392,297,95,42,263,246,155,102,17
1400000US24510030200,"Census Tract 302, Baltimore city, Maryland",2116,317,307,121,245,10,444,384,174,221,60,138,138,126,12,0,128,128,128,0,0,1089,1072,1059,111,17
1400000US24510040100,"Census Tract 401, Baltimore city, Maryland",3961,790,790,566,257,0,680,680,680,0,0,987,987,943,84,0,552,552,552,16,0,952,863,841,145,89
1400000US24510040200,"Census Tract 402, Baltimore city, Maryland",304,82,71,49,33,11,60,56,40,16,4,64,64,64,5,0,29,16,16,6,13,69,65,65,8,4
1400000US24510060100,"Census Tract 601, Baltimore city, Maryland",2938,1108,924,174,816,184,433,421,246,196,12,246,238,188,96,8,398,398,320,78,0,753,713,652,83,40
1400000US24510060200,"Census Tract 602, Baltimore city, Maryland",3061,593,519,100,450,74,317,176,98,95,141,977,730,531,388,247,120,120,120,34,0,1054,1054,1036,56,0
1400000US24510060300,"Census Tract 603, Baltimore city, Maryland",1902,260,229,69,173,31,562,424,175,291,138,242,225,165,68,17,226,221,185,66,5,612,574,485,108,38
1400000US24510060400,"Census Tract 604, Baltimore city, Maryland",1433,328,284,84,257,44,186,177,153,48,9,320,305,187,138,15,105,105,69,44,0,494,491,440,91,3
1400000US24510070100,"Census Tract 701, Baltimore city, Maryland",2884,781,702,151,648,79,1077,1071,169,947,6,524,465,259,281,59,305,209,103,106,96,197,184,145,46,13
1400000US24510070200,"Census Tract 702, Baltimore city, Maryland",2804,1151,1021,212,929,130,676,602,322,389,74,352,290,102,202,62,198,146,47,106,52,427,310,185,167,117
1400000US24510070300,"Census Tract 703, Baltimore city, Maryland",863,353,269,78,263,84,275,227,115,131,48,56,56,47,13,0,50,44,44,0,6,129,91,33,73,38
1400000US24510070400,"Census Tract 704, Baltimore city, Maryland",1477,683,573,139,480,110,525,449,339,190,76,111,111,95,36,0,40,33,27,12,7,118,117,117,4,1
1400000US24510080101,"Census Tract 801.01, Baltimore city, Maryland",3963,560,522,39,512,38,785,713,384,445,72,830,814,426,439,16,715,689,497,217,26,1073,1038,849,267,35
1400000US24510080102,"Census Tract 801.02, Baltimore city, Maryland",2181,707,686,136,618,21,773,674,226,484,99,445,425,287,156,20,98,77,32,62,21,158,158,153,12,0
1400000US24510080200,"Census Tract 802, Baltimore city, Maryland",1539,425,404,43,404,21,312,301,99,218,11,271,271,128,162,0,228,228,190,52,0,303,303,226,114,0
1400000US24510080301,"Census Tract 803.01, Baltimore city, Maryland",1650,451,387,74,376,64,510,491,205,367,19,293,249,176,148,44,141,141,52,97,0,255,192,181,16,63
1400000US24510080302,"Census Tract 803.02, Baltimore city, Maryland",3002,760,639,184,556,121,1140,997,442,713,143,251,251,251,149,0,408,408,237,227,0,443,443,306,215,0
1400000US24510080400,"Census Tract 804, Baltimore city, Maryland",1166,389,304,80,285,85,271,248,81,167,23,247,230,88,156,17,14,14,14,0,0,245,238,129,109,7
1400000US24510080500,"Census Tract 805, Baltimore city, Maryland",1683,527,511,110,478,16,734,641,257,469,93,129,129,107,37,0,126,101,90,53,25,167,167,120,84,0
1400000US24510080600,"Census Tract 806, Baltimore city, Maryland",2382,655,645,96,608,10,560,542,190,416,18,440,416,122,333,24,378,330,172,170,48,349,334,222,153,15
1400000US24510080700,"Census Tract 807, Baltimore city, Maryland",692,180,176,21,161,4,359,340,121,255,19,50,50,43,7,0,55,42,30,12,13,48,48,48,8,0
1400000US24510080800,"Census Tract 808, Baltimore city, Maryland",1452,552,547,40,544,5,287,202,108,140,85,239,227,120,120,12,239,239,126,113,0,135,135,127,8,0
1400000US24510090100,"Census Tract 901, Baltimore city, Maryland",4009,882,794,170,689,88,1154,1095,700,672,59,707,683,563,236,24,438,425,343,113,13,828,820,708,225,8
1400000US24510090200,"Census Tract 902, Baltimore city, Maryland",2940,246,201,130,134,45,476,476,387,258,0,509,489,332,199,20,383,351,276,198,32,1326,1326,1172,246,0
1400000US24510090300,"Census Tract 903, Baltimore city, Maryland",4553,1538,1462,513,1336,76,616,601,325,436,15,572,439,350,158,133,753,736,623,276,17,1074,1000,926,218,74
1400000US24510090400,"Census Tract 904, Baltimore city, Maryland",1756,574,481,207,350,93,569,426,209,294,143,299,269,146,123,30,171,138,128,49,33,143,143,114,29,0
1400000US24510090500,"Census Tract 905, Baltimore city, Maryland",1937,284,258,51,229,26,529,523,266,357,6,472,425,333,153,47,249,231,231,163,18,403,390,225,165,13
1400000US24510090600,"Census Tract 906, Baltimore city, Maryland",3221,908,899,449,540,9,653,570,383,359,83,754,687,355,500,67,44,44,44,23,0,862,707,635,85,155
1400000US24510090700,"Census Tract 907, Baltimore city, Maryland",3090,769,713,319,594,56,1134,1060,733,640,74,815,710,360,447,105,212,212,180,41,0,160,160,122,74,0
1400000US24510090800,"Census Tract 908, Baltimore city, Maryland",2797,966,824,403,739,142,683,657,348,533,26,324,302,178,197,22,274,240,77,168,34,550,484,347,199,66
1400000US24510090900,"Census Tract 909, Baltimore city, Maryland",2484,875,810,162,715,65,748,614,138,493,134,555,530,422,161,25,161,161,161,0,0,145,145,72,100,0
1400000US24510100100,"Census Tract 1001, Baltimore city, Maryland",2228,776,749,147,684,27,574,509,249,354,65,709,651,252,475,58,57,57,48,36,0,112,112,102,10,0
1400000US24510100200,"Census Tract 1002, Baltimore city, Maryland",2383,1231,1188,180,1090,43,364,364,92,284,0,567,555,450,186,12,208,208,15,193,0,13,13,13,13,0
1400000US24510100300,"Census Tract 1003, Baltimore city, Maryland",0,0,0,0,0,0,0,0,0,0,0,0,0,0,0,0,0,0,0,0,0,0,0,0,0,0
1400000US24510110100,"Census Tract 1101, Baltimore city, Maryland",2920,416,390,339,97,26,963,860,860,0,103,556,537,447,147,19,445,445,433,12,0,540,540,540,29,0
1400000US24510110200,"Census Tract 1102, Baltimore city, Maryland",5037,1361,1255,521,900,106,964,916,832,163,48,837,782,731,118,55,617,617,617,17,0,1258,1258,1244,88,0
1400000US24510120100,"Census Tract 1201, Baltimore city, Maryland",4602,830,756,680,208,74,856,846,616,341,10,632,618,537,175,14,421,421,389,219,0,1863,1828,1730,646,35
1400000US24510120201,"Census Tract 1202.01, Baltimore city, Maryland",1986,212,206,158,67,6,267,235,193,69,32,380,366,360,30,14,326,270,226,58,56,801,796,772,50,5
1400000US24510120202,"Census Tract 1202.02, Baltimore city, Maryland",3128,1003,915,874,41,88,845,828,777,137,17,153,153,153,26,0,519,486,450,45,33,608,608,608,69,0
1400000US24510120300,"Census Tract 1203, Baltimore city, Maryland",3874,1063,954,258,754,109,647,567,474,279,80,658,658,590,98,0,527,527,476,51,0,979,915,871,44,64
1400000US24510120400,"Census Tract 1204, Baltimore city, Maryland",1678,632,600,108,526,32,390,342,192,198,48,306,258,189,96,48,172,168,139,38,4,178,150,145,11,28
1400000US24510120500,"Census Tract 1205, Baltimore city, Maryland",2251,524,492,166,409,32,332,315,173,188,17,565,535,368,219,30,375,326,301,25,49,455,396,355,68,59
1400000US24510120600,"Census Tract 1206, Baltimore city, Maryland",2392,1090,979,231,874,111,555,474,330,189,81,270,258,228,35,12,126,126,114,12,0,351,339,328,33,12
1400000US24510120700,"Census Tract 1207, Baltimore city, Maryland",2204,295,295,120,183,0,584,527,310,280,57,401,401,329,103,0,333,265,198,67,68,591,557,542,91,34
1400000US24510130100,"Census Tract 1301, Baltimore city, Maryland",2727,1033,1003,132,977,30,501,420,288,197,81,386,374,283,161,12,131,112,112,0,19,676,651,598,104,25
1400000US24510130200,"Census Tract 1302, Baltimore city, Maryland",3189,828,725,272,507,103,769,714,295,482,55,433,429,351,108,4,447,409,313,172,38,712,699,637,143,13
1400000US24510130300,"Census Tract 1303, Baltimore city, Maryland",2446,918,866,70,834,52,532,463,206,345,69,347,332,130,239,15,309,309,194,122,0,340,325,285,87,15
1400000US24510130400,"Census Tract 1304, Baltimore city, Maryland",2166,801,729,129,617,72,535,478,227,319,57,294,281,231,101,13,392,366,205,215,26,144,139,113,55,5
1400000US24510130600,"Census Tract 1306, Baltimore city, Maryland",3682,337,306,77,293,31,446,396,336,124,50,592,592,557,79,0,571,522,446,89,49,1736,1680,1648,99,56
1400000US24510130700,"Census Tract 1307, Baltimore city, Maryland",4419,610,558,279,424,52,803,776,581,605,27,764,764,687,143,0,401,388,388,39,13,1841,1819,1767,156,22
1400000US24510130803,"Census Tract 1308.03, Baltimore city, Maryland",2416,305,249,94,180,56,564,525,358,220,39,577,558,298,322,19,182,171,123,59,11,788,764,747,50,24
1400000US24510130804,"Census Tract 1308.04, Baltimore city, Maryland",1942,294,254,37,234,40,269,261,192,99,8,458,411,328,92,47,280,266,250,21,14,641,599,529,90,42
1400000US24510130805,"Census Tract 1308.05, Baltimore city, Maryland",906,227,214,77,204,13,101,101,56,79,0,146,146,135,30,0,292,254,191,89,38,140,134,128,22,6
1400000US24510130806,"Census Tract 1308.06, Baltimore city, Maryland",1160,101,86,52,64,15,90,73,57,35,17,266,258,206,69,8,136,136,136,0,0,567,523,491,83,44
1400000US24510140100,"Census Tract 1401, Baltimore city, Maryland",4210,878,814,306,636,64,662,590,338,421,72,414,394,304,136,20,633,557,489,94,76,1623,1476,1376,251,147
1400000US24510140200,"Census Tract 1402, Baltimore city, Maryland",2632,1496,1358,41,1329,138,566,492,89,438,74,108,108,80,40,0,174,174,142,42,0,288,288,262,43,0
1400000US24510140300,"Census Tract 1403, Baltimore city, Maryland",2800,1072,980,259,892,92,845,805,418,483,40,330,276,180,108,54,158,143,98,78,15,395,387,323,115,8
1400000US24510150100,"Census Tract 1501, Baltimore city, Maryland",2662,1301,1246,155,1177,55,635,571,269,381,64,495,334,162,207,161,134,119,81,57,15,97,97,56,83,0
1400000US24510150200,"Census Tract 1502, Baltimore city, Maryland",2573,529,481,54,470,48,610,411,226,229,199,967,912,279,649,55,85,65,29,42,20,382,382,173,209,0
1400000US24510150300,"Census Tract 1503, Baltimore city, Maryland",2117,445,390,102,312,55,636,602,340,294,34,409,355,215,198,54,275,192,121,126,83,352,336,214,136,16
1400000US24510150400,"Census Tract 1504, Baltimore city, Maryland",3066,860,795,228,648,65,903,817,270,613,86,728,711,368,431,17,399,303,87,246,96,176,144,82,97,32
1400000US24510150500,"Census Tract 1505, Baltimore city, Maryland",1582,388,350,160,293,38,394,360,177,246,34,436,371,96,293,65,168,155,121,66,13,196,196,169,71,0
1400000US24510150600,"Census Tract 1506, Baltimore city, Maryland",2922,991,944,198,818,47,439,407,235,256,32,467,431,213,277,36,472,365,202,197,107,553,553,359,258,0
1400000US24510150701,"Census Tract 1507.01, Baltimore city, Maryland",1547,354,307,90,291,47,422,386,196,254,36,400,375,251,193,25,15,15,15,10,0,356,338,312,105,18
1400000US24510150702,"Census Tract 1507.02, Baltimore city, Maryland",2185,492,492,134,440,0,577,500,172,360,77,302,302,284,102,0,322,315,228,109,7,492,492,364,190,0
1400000US24510150800,"Census Tract 1508, Baltimore city, Maryland",4238,1110,978,218,888,132,990,928,288,853,62,774,688,513,248,86,664,664,453,291,0,700,690,595,198,10
1400000US24510150900,"Census Tract 1509, Baltimore city, Maryland",3327,849,763,256,642,86,423,333,164,262,90,883,746,498,370,137,471,458,424,105,13,701,701,615,220,0
1400000US24510151000,"Census Tract 1510, Baltimore city, Maryland",4555,993,946,293,832,47,1118,981,374,736,137,906,857,561,383,49,625,525,376,198,100,913,823,628,335,90
1400000US24510151100,"Census Tract 1511, Baltimore city, Maryland",6902,1415,1281,563,906,134,1801,1650,518,1359,151,1229,1189,939,369,40,773,569,414,264,204,1684,1625,1344,299,59
1400000US24510151200,"Census Tract 1512, Baltimore city, Maryland",4697,1991,1780,181,1720,211,1076,925,377,721,151,644,644,516,292,0,211,176,176,10,35,775,716,561,241,59
1400000US24510151300,"Census Tract 1513, Baltimore city, Maryland",4150,1653,1548,270,1414,105,1102,1001,522,607,101,235,225,139,116,10,760,741,401,392,19,400,386,249,198,14
1400000US24510160100,"Census Tract 1601, Baltimore city, Maryland",1998,733,676,159,613,57,612,517,206,364,95,289,253,221,127,36,113,113,113,13,0,251,229,194,35,22
1400000US24510160200,"Census Tract 1602, Baltimore city, Maryland",2389,961,937,369,617,24,569,540,275,333,29,268,245,104,175,23,275,251,177,89,24,316,251,205,52,65
1400000US24510160300,"Census Tract 1603, Baltimore city, Maryland",919,388,368,57,328,20,299,268,162,239,31,108,81,74,14,27,86,86,71,15,0,38,38,12,29,0
1400000US24510160400,"Census Tract 1604, Baltimore city, Maryland",2452,1216,1125,197,1015,91,315,287,95,210,28,521,453,225,258,68,192,180,60,120,12,208,208,158,50,0
1400000US24510160500,"Census Tract 1605, Baltimore city, Maryland",4605,1096,998,153,937,98,1634,1433,655,927,201,808,730,476,328,78,847,798,575,335,49,220,220,136,129,0
1400000US24510160600,"Census Tract 1606, Baltimore city, Maryland",3374,1081,938,138,870,143,705,613,233,427,92,422,381,162,277,41,736,713,415,360,23,430,370,296,145,60
1400000US24510160700,"Census Tract 1607, Baltimore city, Maryland",4311,1079,969,208,903,110,1881,1780,634,1279,101,922,728,466,367,194,124,124,100,33,0,305,305,295,29,0
1400000US24510160801,"Census Tract 1608.01, Baltimore city, Maryland",3128,522,508,253,362,14,1125,973,489,615,152,715,667,348,399,48,302,302,271,66,0,464,432,302,164,32
1400000US24510160802,"Census Tract 1608.02, Baltimore city, Maryland",3364,524,488,74,440,36,1491,1210,685,726,281,500,457,330,195,43,394,335,220,152,59,455,440,369,128,15
1400000US24510170100,"Census Tract 1701, Baltimore city, Maryland",1602,607,562,158,475,45,418,379,199,222,39,206,154,146,22,52,177,145,124,35,32,194,194,194,30,0
1400000US24510170200,"Census Tract 1702, Baltimore city, Maryland",3033,1891,1836,537,1494,55,696,629,244,432,67,323,180,91,89,143,78,78,41,60,0,45,26,26,0,19
1400000US24510170300,"Census Tract 1703, Baltimore city, Maryland",1630,697,638,221,524,59,331,304,142,194,27,393,393,345,57,0,50,50,50,0,0,159,159,132,33,0
1400000US24510180100,"Census Tract 1801, Baltimore city, Maryland",2253,1452,1427,196,1354,25,653,563,186,404,90,116,116,116,9,0,18,18,18,0,0,14,9,5,6,5
1400000US24510180200,"Census Tract 1802, Baltimore city, Maryland",803,343,255,33,249,88,233,174,80,110,59,108,108,108,0,0,4,4,4,0,0,115,106,84,61,9
1400000US24510180300,"Census Tract 1803, Baltimore city, Maryland",1651,573,526,163,429,47,112,112,102,10,0,347,297,249,57,50,315,309,309,36,6,304,282,203,96,22
1400000US24510190100,"Census Tract 1901, Baltimore city, Maryland",2038,798,798,118,727,0,513,493,156,363,20,421,378,107,297,43,245,129,43,96,116,61,61,61,9,0
1400000US24510190200,"Census Tract 1902, Baltimore city, Maryland",1877,590,561,178,495,29,331,317,163,176,14,344,326,189,148,18,254,163,106,87,91,358,288,250,57,70
1400000US24510190300,"Census Tract 1903, Baltimore city, Maryland",2374,1156,1088,107,1048,68,336,282,77,245,54,612,473,154,383,139,193,137,37,100,56,77,77,49,32,0
1400000US24510200100,"Census Tract 2001, Baltimore city, Maryland",1724,659,611,46,596,48,444,387,198,254,57,330,311,219,183,19,166,162,105,71,4,125,102,0,102,23
1400000US24510200200,"Census Tract 2002, Baltimore city, Maryland",2618,1038,1013,147,942,25,705,642,224,543,63,559,529,120,420,30,169,169,143,54,0,147,147,99,48,0
1400000US24510200300,"Census Tract 2003, Baltimore city, Maryland",1594,604,565,54,558,39,469,422,86,342,47,191,183,30,168,8,78,78,59,37,0,252,225,98,127,27
1400000US24510200400,"Census Tract 2004, Baltimore city, Maryland",1549,544,496,91,449,48,721,706,258,507,15,207,201,93,143,6,66,55,18,39,11,11,11,11,0,0
1400000US24510200500,"Census Tract 2005, Baltimore city, Maryland",2943,1226,1025,69,1017,201,482,420,162,340,62,716,595,269,431,121,372,271,86,201,101,147,109,92,65,38
1400000US24510200600,"Census Tract 2006, Baltimore city, Maryland",2276,609,596,264,476,13,583,545,137,436,38,560,473,187,385,87,342,342,318,24,0,182,182,88,152,0
1400000US24510200701,"Census Tract 2007.01, Baltimore city, Maryland",5462,1419,1277,217,1175,142,1715,1511,390,1213,204,1122,1019,593,599,103,621,514,313,251,107,585,496,358,198,89
1400000US24510200702,"Census Tract 2007.02, Baltimore city, Maryland",1100,397,342,152,277,55,380,340,177,230,40,220,220,175,55,0,103,103,64,39,0,0,0,0,0,0
1400000US24510200800,"Census Tract 2008, Baltimore city, Maryland",2042,575,551,130,500,24,518,446,253,229,72,427,383,196,200,44,316,294,226,142,22,206,191,110,92,15
1400000US24510210100,"Census Tract 2101, Baltimore city, Maryland",2374,602,551,104,499,51,455,440,300,281,15,513,491,280,232,22,167,167,159,24,0,637,599,457,157,38
1400000US24510210200,"Census Tract 2102, Baltimore city, Maryland",3025,1029,795,236,650,234,632,627,254,442,5,544,477,304,196,67,160,150,122,45,10,660,589,503,121,71
1400000US24510220100,"Census Tract 2201, Baltimore city, Maryland",4248,672,640,236,428,32,534,474,356,249,60,500,471,361,133,29,357,275,250,25,82,2185,2168,2096,223,17
1400000US24510230100,"Census Tract 2301, Baltimore city, Maryland",1800,313,302,174,228,11,457,401,207,301,56,172,158,145,19,14,62,62,62,3,0,796,776,704,78,20
1400000US24510230200,"Census Tract 2302, Baltimore city, Maryland",2159,106,78,43,47,28,123,114,98,42,9,335,321,237,145,14,263,263,263,11,0,1332,1320,1293,66,12
1400000US24510230300,"Census Tract 2303, Baltimore city, Maryland",1277,86,67,48,30,19,73,65,56,25,8,117,112,112,24,5,150,148,134,24,2,851,851,808,49,0
1400000US24510240100,"Census Tract 2401, Baltimore city, Maryland",3059,155,140,99,57,15,348,341,258,161,7,238,232,208,64,6,286,279,256,39,7,2032,2032,2009,80,0
1400000US24510240200,"Census Tract 2402, Baltimore city, Maryland",3210,109,102,73,73,7,271,271,271,42,0,275,275,250,49,0,271,271,271,31,0,2284,2251,2157,262,33
1400000US24510240300,"Census Tract 2403, Baltimore city, Maryland",2027,119,119,65,68,0,107,91,64,27,16,300,300,288,28,0,236,207,207,43,29,1265,1227,1227,58,38
1400000US24510240400,"Census Tract 2404, Baltimore city, Maryland",2871,64,55,35,37,9,199,157,68,117,42,470,404,277,149,66,457,429,429,16,28,1681,1662,1615,95,19
1400000US24510250101,"Census Tract 2501.01, Baltimore city, Maryland",4308,681,648,228,508,33,913,832,451,499,81,965,949,894,105,16,782,760,458,372,22,967,937,872,140,30
1400000US24510250102,"Census Tract 2501.02, Baltimore city, Maryland",3250,520,496,221,364,24,996,964,161,855,32,1003,972,744,375,31,441,431,353,78,10,290,290,285,8,0
1400000US24510250103,"Census Tract 2501.03, Baltimore city, Maryland",3092,822,797,231,673,25,574,513,262,281,61,569,545,403,219,24,449,393,257,152,56,678,650,525,149,28
1400000US24510250203,"Census Tract 2502.03, Baltimore city, Maryland",1938,471,432,52,417,39,529,427,192,254,102,342,274,183,109,68,226,173,122,69,53,370,370,239,175,0
1400000US24510250204,"Census Tract 2502.04, Baltimore city, Maryland",4037,2573,2433,135,2407,140,789,789,295,522,0,235,226,118,108,9,156,136,78,67,20,284,262,156,112,22
1400000US24510250205,"Census Tract 2502.05, Baltimore city, Maryland",4397,1072,917,136,839,155,1086,951,539,460,135,884,812,595,402,72,946,829,537,314,117,409,321,233,88,88
1400000US24510250206,"Census Tract 2502.06, Baltimore city, Maryland",2021,184,104,48,91,80,560,542,382,223,18,515,303,202,157,212,228,228,228,18,0,534,534,470,100,0
1400000US24510250207,"Census Tract 2502.07, Baltimore city, Maryland",2093,603,552,139,468,51,766,665,272,428,101,217,200,135,65,17,235,218,188,38,17,272,272,202,94,0
1400000US24510250301,"Census Tract 2503.01, Baltimore city, Maryland",2348,911,853,127,826,58,385,380,140,276,5,568,549,355,214,19,378,319,261,156,59,106,102,102,4,4
1400000US24510250303,"Census Tract 2503.03, Baltimore city, Maryland",2221,742,611,240,570,131,644,533,229,370,111,336,308,214,174,28,214,205,114,143,9,285,285,256,63,0
1400000US24510250401,"Census Tract 2504.01, Baltimore city, Maryland",3495,772,710,203,564,62,1277,894,403,624,383,357,348,279,85,9,192,192,113,121,0,897,804,372,479,93
1400000US24510250402,"Census Tract 2504.02, Baltimore city, Maryland",4216,1045,854,119,844,191,1062,920,342,667,142,775,688,407,319,87,918,886,771,297,32,416,405,352,53,11
1400000US24510250500,"Census Tract 2505, Baltimore city, Maryland",5171,1703,1652,157,1595,51,1205,1008,324,771,197,813,555,346,239,258,711,677,415,322,34,739,739,445,420,0
1400000US24510250600,"Census Tract 2506, Baltimore city, Maryland",0,0,0,0,0,0,0,0,0,0,0,0,0,0,0,0,0,0,0,0,0,0,0,0,0,0
1400000US24510260101,"Census Tract 2601.01, Baltimore city, Maryland",4695,536,456,120,376,80,1062,1008,721,372,54,902,836,641,299,66,565,517,374,201,48,1630,1318,1132,313,312
1400000US24510260102,"Census Tract 2601.02, Baltimore city, Maryland",4742,642,598,196,448,44,1198,1136,685,730,62,964,892,648,299,72,739,717,580,190,22,1199,1192,1127,158,7
1400000US24510260201,"Census Tract 2602.01, Baltimore city, Maryland",4894,1199,854,316,636,345,1398,1349,824,611,49,590,590,534,77,0,510,478,330,148,32,1197,1086,696,469,111
1400000US24510260202,"Census Tract 2602.02, Baltimore city, Maryland",5780,1403,1308,237,1127,95,1723,1555,769,1017,168,1221,1183,664,565,38,1003,949,426,563,54,430,430,204,240,0
1400000US24510260203,"Census Tract 2602.03, Baltimore city, Maryland",3029,595,473,105,458,122,981,871,355,642,110,295,277,162,168,18,555,498,483,33,57,603,560,349,247,43
1400000US24510260301,"Census Tract 2603.01, Baltimore city, Maryland",4644,1326,1267,131,1155,59,1477,1354,687,706,123,532,498,279,251,34,760,746,544,251,14,549,478,412,121,71
1400000US24510260302,"Census Tract 2603.02, Baltimore city, Maryland",6552,2553,2155,799,1697,398,1275,1215,849,574,60,1533,1533,976,654,0,624,624,396,349,0,567,481,426,146,86
1400000US24510260303,"Census Tract 2603.03, Baltimore city, Maryland",947,414,404,80,362,10,312,276,95,212,36,132,113,54,70,19,8,8,8,8,0,81,51,35,16,30
1400000US24510260401,"Census Tract 2604.01, Baltimore city, Maryland",3533,1065,967,167,877,98,1294,1166,480,796,128,413,357,220,149,56,598,526,186,359,72,163,91,91,0,72
1400000US24510260402,"Census Tract 2604.02, Baltimore city, Maryland",2977,679,656,161,537,23,652,525,323,263,127,568,549,441,221,19,704,704,673,43,0,374,374,327,78,0
1400000US24510260403,"Census Tract 2604.03, Baltimore city, Maryland",1840,643,636,154,529,7,473,446,280,183,27,300,238,151,109,62,31,31,31,4,0,393,375,342,46,18
1400000US24510260404,"Census Tract 2604.04, Baltimore city, Maryland",2272,527,509,44,487,18,468,380,95,305,88,380,233,160,96,147,228,190,115,76,38,669,287,145,158,382
1400000US24510260501,"Census Tract 2605.01, Baltimore city, Maryland",5724,572,542,175,460,30,1362,1118,300,980,244,1283,833,440,441,450,1375,1007,468,588,368,1132,946,742,363,186
1400000US24510260604,"Census Tract 2606.04, Baltimore city, Maryland",1435,794,763,27,742,31,382,304,109,211,78,62,62,62,0,0,157,130,79,60,27,40,40,0,40,0
1400000US24510260605,"Census Tract 2606.05, Baltimore city, Maryland",4581,1329,964,233,827,365,1149,934,496,640,215,1021,907,373,636,114,598,545,474,111,53,484,484,383,136,0
1400000US24510260700,"Census Tract 2607, Baltimore city, Maryland",2682,500,408,125,324,92,400,374,321,114,26,432,267,138,150,165,703,548,454,176,155,647,481,384,145,166
1400000US24510260800,"Census Tract 2608, Baltimore city, Maryland",2696,672,420,62,415,252,726,532,425,191,194,488,376,267,150,112,208,156,133,30,52,602,313,249,80,289
1400000US24510260900,"Census Tract 2609, Baltimore city, Maryland",3101,234,203,133,149,31,354,354,255,166,0,297,297,252,45,0,415,387,346,86,28,1801,1784,1697,160,17
1400000US24510261000,"Census Tract 2610, Baltimore city, Maryland",3073,319,239,30,238,80,1027,767,218,575,260,438,404,299,225,34,481,357,211,176,124,808,721,658,148,87
1400000US24510261100,"Census Tract 2611, Baltimore city, Maryland",1809,111,105,50,66,6,200,157,111,76,43,141,141,122,36,0,216,216,176,48,0,1141,1123,1120,37,18
1400000US24510270101,"Census Tract 2701.01, Baltimore city, Maryland",1568,327,304,132,208,23,251,213,71,162,38,326,316,277,67,10,112,112,80,44,0,552,519,467,99,33
1400000US24510270102,"Census Tract 2701.02, Baltimore city, Maryland",3904,348,326,43,307,22,488,442,295,267,46,1220,1023,699,475,197,919,771,644,191,148,929,859,732,193,70
1400000US24510270200,"Census Tract 2702, Baltimore city, Maryland",1757,155,145,86,107,10,234,209,109,140,25,440,405,188,265,35,358,283,233,88,75,570,540,465,120,30
1400000US24510270301,"Census Tract 2703.01, Baltimore city, Maryland",2927,260,228,162,105,32,356,356,237,211,0,569,476,301,267,93,469,469,399,105,0,1273,1146,915,299,127
1400000US24510270302,"Census Tract 2703.02, Baltimore city, Maryland",1832,114,104,30,86,10,398,375,106,290,23,390,327,279,98,63,280,271,261,36,9,650,593,478,172,57
1400000US24510270401,"Census Tract 2704.01, Baltimore city, Maryland",6054,955,955,125,887,0,1316,1221,846,511,95,631,631,523,260,0,1622,1592,1441,323,30,1530,1461,1349,146,69
1400000US24510270402,"Census Tract 2704.02, Baltimore city, Maryland",3374,257,200,91,171,57,357,338,163,215,19,672,607,397,344,65,777,767,549,322,10,1311,1311,1114,295,0
1400000US24510270501,"Census Tract 2705.01, Baltimore city, Maryland",3979,397,329,247,160,68,688,667,443,433,21,638,605,495,262,33,714,703,651,137,11,1542,1542,1485,143,0
1400000US24510270502,"Census Tract 2705.02, Baltimore city, Maryland",4239,538,481,158,383,57,657,649,417,276,8,623,623,489,261,0,611,530,459,124,81,1810,1800,1578,441,10
1400000US24510270600,"Census Tract 2706, Baltimore city, Maryland",4877,560,513,164,456,47,1214,1165,549,863,49,919,892,694,300,27,866,866,694,258,0,1318,1297,1169,220,21
1400000US24510270701,"Census Tract 2707.01, Baltimore city, Maryland",2654,607,509,211,303,98,530,438,312,207,92,701,635,302,387,66,397,342,244,110,55,419,331,158,173,88
1400000US24510270702,"Census Tract 2707.02, Baltimore city, Maryland",1957,321,291,78,247,30,482,456,397,124,26,541,496,330,260,45,280,230,144,117,50,333,333,296,61,0
1400000US24510270703,"Census Tract 2707.03, Baltimore city, Maryland",2613,171,165,87,99,6,579,501,293,316,78,727,673,510,274,54,323,323,323,69,0,813,724,629,148,89
1400000US24510270801,"Census Tract 2708.01, Baltimore city, Maryland",4176,554,454,236,298,100,1220,1015,628,619,205,1326,1146,789,554,180,433,418,407,73,15,643,643,611,110,0
1400000US24510270802,"Census Tract 2708.02, Baltimore city, Maryland",5730,638,620,164,579,18,1443,1258,741,743,185,1389,1271,1083,424,118,898,898,486,534,0,1362,1228,954,531,134
1400000US24510270803,"Census Tract 2708.03, Baltimore city, Maryland",6955,652,607,299,442,45,1866,1827,1270,680,39,2005,1914,1504,940,91,913,884,875,149,29,1519,1519,1361,186,0
1400000US24510270804,"Census Tract 2708.04, Baltimore city, Maryland",3153,654,625,226,500,29,434,384,314,113,50,470,470,470,43,0,680,538,465,97,142,915,781,716,83,134
1400000US24510270805,"Census Tract 2708.05, Baltimore city, Maryland",5248,753,625,178,517,128,974,882,490,581,92,1260,1169,898,376,91,957,854,789,147,103,1304,1228,1061,367,76
1400000US24510270901,"Census Tract 2709.01, Baltimore city, Maryland",4190,674,576,397,294,98,687,687,368,466,0,987,987,714,351,0,929,900,655,353,29,913,847,541,433,66
1400000US24510270902,"Census Tract 2709.02, Baltimore city, Maryland",4051,501,501,226,384,0,946,914,451,645,32,1260,1212,969,406,48,421,396,396,136,25,923,880,873,258,43
1400000US24510270903,"Census Tract 2709.03, Baltimore city, Maryland",2552,654,522,94,475,132,658,537,445,214,121,440,374,279,169,66,164,164,93,126,0,636,623,623,81,13
1400000US24510271001,"Census Tract 2710.01, Baltimore city, Maryland",2369,570,469,158,429,101,566,543,230,413,23,723,653,395,317,70,149,126,53,84,23,361,331,263,116,30
1400000US24510271002,"Census Tract 2710.02, Baltimore city, Maryland",4264,1137,938,199,839,199,1286,1189,398,979,97,832,801,557,323,31,312,252,184,95,60,697,697,563,201,0
1400000US24510271101,"Census Tract 2711.01, Baltimore city, Maryland",1905,442,406,116,333,36,350,338,204,162,12,230,181,150,41,49,180,173,173,22,7,703,694,681,54,9
1400000US24510271102,"Census Tract 2711.02, Baltimore city, Maryland",1212,30,30,24,6,0,30,30,30,6,0,127,120,120,39,7,17,8,8,0,9,1008,1008,937,187,0
1400000US24510271200,"Census Tract 2712, Baltimore city, Maryland",6422,237,217,63,188,20,528,517,286,335,11,373,373,326,152,0,947,876,673,360,71,4337,4287,4220,530,50
1400000US24510271300,"Census Tract 2713, Baltimore city, Maryland",2642,50,31,31,25,19,89,89,74,28,0,243,213,213,46,30,158,137,137,44,21,2102,2084,2013,417,18
1400000US24510271400,"Census Tract 2714, Baltimore city, Maryland",3603,254,246,217,121,8,282,256,249,123,26,287,287,266,49,0,281,267,267,63,14,2499,2451,2425,408,48
1400000US24510271501,"Census Tract 2715.01, Baltimore city, Maryland",3997,261,254,185,121,7,522,499,300,285,23,383,365,339,71,18,447,433,413,94,14,2384,2384,2339,317,0
1400000US24510271503,"Census Tract 2715.03, Baltimore city, Maryland",863,111,95,78,51,16,151,151,104,112,0,157,157,142,60,0,119,119,113,39,0,325,325,301,123,0
1400000US24510271600,"Census Tract 2716, Baltimore city, Maryland",4478,1592,1419,364,1223,173,844,738,260,541,106,983,860,520,425,123,503,414,252,171,89,556,543,401,250,13
1400000US24510271700,"Census Tract 2717, Baltimore city, Maryland",4721,1121,1055,286,883,66,1241,1122,503,770,119,894,827,357,577,67,587,587,389,228,0,878,798,586,323,80
1400000US24510271801,"Census Tract 2718.01, Baltimore city, Maryland",2925,1132,1080,391,915,52,457,415,239,260,42,269,234,174,101,35,441,328,151,205,113,626,589,393,271,37
1400000US24510271802,"Census Tract 2718.02, Baltimore city, Maryland",2543,925,802,98,740,123,998,803,423,515,195,315,304,218,122,11,69,69,54,62,0,236,224,184,88,12
1400000US24510271900,"Census Tract 2719, Baltimore city, Maryland",3912,872,792,396,558,80,690,690,340,501,0,500,458,328,247,42,339,329,254,191,10,1511,1479,1338,311,32
1400000US24510272003,"Census Tract 2720.03, Baltimore city, Maryland",5665,350,333,150,270,17,765,694,514,412,71,1014,838,692,336,176,423,390,247,167,33,3113,2904,2529,747,209
1400000US24510272004,"Census Tract 2720.04, Baltimore city, Maryland",3811,823,777,373,735,46,1221,1204,719,809,17,528,528,373,280,0,189,189,108,147,0,1050,1025,1009,111,25
1400000US24510272005,"Census Tract 2720.05, Baltimore city, Maryland",3440,440,440,199,355,0,814,778,482,418,36,491,480,262,289,11,317,317,272,98,0,1378,1272,1157,226,106
1400000US24510272006,"Census Tract 2720.06, Baltimore city, Maryland",3498,1057,946,271,826,111,527,464,337,308,63,846,812,578,294,34,458,427,299,160,31,610,599,418,260,11
1400000US24510272007,"Census Tract 2720.07, Baltimore city, Maryland",4619,1114,897,300,756,217,1252,1181,707,712,71,854,829,685,241,25,521,386,316,124,135,878,878,786,204,0
1400000US24510280101,"Census Tract 2801.01, Baltimore city, Maryland",3737,904,777,126,758,127,914,726,369,480,188,638,613,445,252,25,630,550,354,235,80,651,651,596,101,0
1400000US24510280102,"Census Tract 2801.02, Baltimore city, Maryland",6011,1264,1108,571,1042,156,815,763,549,397,52,2109,1982,1323,792,127,1289,1062,692,450,227,534,534,430,148,0
1400000US24510280200,"Census Tract 2802, Baltimore city, Maryland",4964,760,697,337,661,63,872,824,327,650,48,527,482,343,254,45,1279,1067,819,412,212,1526,1498,1226,539,28
1400000US24510280301,"Census Tract 2803.01, Baltimore city, Maryland",3721,1151,1125,324,983,26,907,887,377,554,20,646,602,418,193,44,588,536,423,213,52,429,404,394,66,25
1400000US24510280302,"Census Tract 2803.02, Baltimore city, Maryland",2492,566,552,127,455,14,665,635,387,324,30,449,428,276,198,21,147,135,102,55,12,665,645,538,198,20
1400000US24510280401,"Census Tract 2804.01, Baltimore city, Maryland",3598,677,655,191,617,22,713,665,446,357,48,862,741,544,314,121,457,407,343,75,50,889,878,807,220,11
1400000US24510280402,"Census Tract 2804.02, Baltimore city, Maryland",1652,335,310,147,243,25,595,580,399,310,15,327,310,215,141,17,224,203,169,62,21,171,171,112,73,0
1400000US24510280403,"Census Tract 2804.03, Baltimore city, Maryland",5292,556,556,428,332,0,1016,977,415,587,39,1083,1024,927,353,59,966,618,563,255,348,1671,1646,1353,488,25
1400000US24510280404,"Census Tract 2804.04, Baltimore city, Maryland",2332,594,568,111,479,26,459,330,156,198,129,533,522,339,255,11,212,212,187,31,0,534,532,388,186,2
1400000US24510280500,"Census Tract 2805, Baltimore city, Maryland",1880,1425,1222,237,1112,203,103,94,62,72,9,267,267,255,12,0,43,35,21,22,8,42,42,42,0,0
