GEO_ID,NAME,total,total.under25K,total.under25K.insured,total.under25K.insured.private,total.under25K.insured.public,total.under25K.uninsured,total.25Kto50K,total.25Kto50K.insured,total.25Kto50K.insured.private,total.25Kto50K.insured.public,total.25Kto50K.uninsured,total.50Kto75K,total.50Kto75K.insured,total.50Kto75K.insured.private,total.50Kto75K.insured.public,total.50Kto75K.uninsured,total.75Kto100K,total.75Kto100K.insured,total.75Kto100K.insured.private,total.75Kto100K.insured.public,total.75Kto100K.uninsured,total.100Kplus,total.100Kplus.insured,total.100Kplus.insured.private,total.100Kplus.insured.public,total.100Kplus.uninsured
1400000US24001000100,"Census Tract 1, Allegany County, Maryland",3334,628,603,391,509,25,771,693,485,447,78,824,766,645,320,58,615,571,523,78,44,496,441,412,55,55
1400000US24001000200,"Census Tract 2, Allegany County, Maryland",2773,541,517,251,386,24,801,741,627,333,60,306,282,261,119,24,482,423,417,38,59,643,532,501,62,111
1400000US24001000300,"Census Tract 3, Allegany County, Maryland",2651,832,777,184,674,55,684,584,458,379,100,573,510,360,231,63,306,274,255,29,32,256,256,256,0,0
1400000US24001000400,"Census Tract 4, Allegany County, Maryland",3002,686,637,265,542,49,915,733,508,425,182,549,542,390,211,7,255,255,210,148,0,597,588,574,34,9
1400000US24001000500,"Census Tract 5, Allegany County, Maryland",2226,922,809,191,665,113,488,405,264,340,83,433,411,378,77,22,133,133,133,0,0,250,250,250,0,0
1400000US24001000600,"Census Tract 6, Allegany County, Maryland",3281,680,680,395,528,0,703,643,414,336,60,714,666,517,261,48,486,438,410,56,48,698,583,527,62,115
1400000US24001000700,"Census Tract 7, Allegany County, Maryland",3430,932,804,331,716,128,1507,1197,548,903,310,363,322,285,91,41,370,311,111,232,59,258,237,223,33,21
1400000US24001000800,"Census Tract 8, Allegany County, Maryland",2035,560,448,177,392,112,788,710,536,480,78,454,447,283,185,7,30,30,30,11,0,203,203,173,104,0
1400000US24001001000,"Census Tract 10, Allegany County, Maryland",2224,841,659,234,590,182,676,495,364,282,181,256,211,181,30,45,314,206,86,120,108,137,90,75,15,47
1400000US24001001100,"Census Tract 11, Allegany County, Maryland",1728,586,537,135,477,49,476,428,253,258,48,252,217,190,71,35,88,88,88,32,0,326,326,318,26,0
1400000US24001001200,"Census Tract 12, Allegany County, Maryland",3056,285,274,118,236,11,707,538,492,221,169,554,439,384,192,115,514,475,457,66,39,996,911,875,157,85
1400000US24001001300,"Census Tract 13, Allegany County, Maryland",2151,500,418,149,381,82,473,434,355,240,39,577,567,514,134,10,402,347,347,18,55,199,191,191,5,8
1400000US24001001401,"Census Tract 14.01, Allegany County, Maryland",3908,486,464,228,377,22,836,751,604,461,85,579,568,535,152,11,1082,1052,1008,109,30,925,913,877,149,12
1400000US24001001402,"Census Tract 14.02, Allegany County, Maryland",1461,290,200,142,168,90,272,264,217,178,8,415,387,356,80,28,297,297,293,8,0,187,187,186,1,0
1400000US24001001502,"Census Tract 15.02, Allegany County, Maryland",1955,440,407,176,329,33,318,295,254,179,23,642,579,440,213,63,114,100,100,0,14,441,432,392,40,9
1400000US24001001503,"Census Tract 15.03, Allegany County, Maryland",1956,313,276,99,227,37,535,473,350,225,62,380,305,296,165,75,319,319,319,38,0,409,409,409,22,0
1400000US24001001600,"Census Tract 16, Allegany County, Maryland",2062,337,271,188,146,66,659,489,352,272,170,331,312,241,142,19,249,237,172,121,12,486,486,431,106,0
1400000US24001001700,"Census Tract 17, Allegany County, Maryland",4364,1440,1347,660,953,93,817,741,518,415,76,1021,937,872,281,84,499,478,450,101,21,587,570,527,58,17
1400000US24001001800,"Census Tract 18, Allegany County, Maryland",3772,1454,1318,1048,417,136,1114,901,678,325,213,613,496,453,149,117,254,254,254,39,0,337,330,330,111,7
1400000US24001001900,"Census Tract 19, Allegany County, Maryland",2516,202,187,117,164,15,866,675,474,378,191,588,554,520,202,34,609,547,506,111,62,251,249,214,35,2
1400000US24001002000,"Census Tract 20, Allegany County, Maryland",5257,849,726,286,621,123,1323,1076,848,621,247,1010,977,884,257,33,505,493,493,138,12,1570,1547,1513,194,23
1400000US24001002100,"Census Tract 21, Allegany County, Maryland",3729,779,659,297,563,120,1297,1184,717,806,113,650,513,418,171,137,303,296,268,79,7,700,679,626,85,21
1400000US24001002200,"Census Tract 22, Allegany County, Maryland",3933,829,747,189,697,82,1064,995,571,726,69,825,764,629,369,61,781,711,679,89,70,434,424,406,31,10
1400000US24003701101,"Census Tract 7011.01, Anne Arundel County, Maryland",4264,207,190,155,93,17,222,156,106,114,66,665,665,520,239,0,358,341,328,72,17,2812,2772,2763,200,40
1400000US24003701102,"Census Tract 7011.02, Anne Arundel County, Maryland",7481,373,328,196,221,45,1187,1082,744,472,105,1426,1156,1030,326,270,1077,987,923,222,90,3418,3119,3028,386,299
1400000US24003701200,"Census Tract 7012, Anne Arundel County, Maryland",8287,405,375,268,205,30,867,770,636,256,97,1097,993,976,154,104,1405,1350,1316,180,55,4513,4186,4079,403,327
1400000US24003701300,"Census Tract 7013, Anne Arundel County, Maryland",7686,202,202,147,153,0,804,674,437,406,130,578,543,497,131,35,1282,1282,1166,378,0,4820,4663,4601,408,157
1400000US24003701400,"Census Tract 7014, Anne Arundel County, Maryland",3567,117,117,87,102,0,163,136,86,85,27,424,381,343,125,43,326,269,248,71,57,2537,2477,2395,436,60
1400000US24003702100,"Census Tract 7021, Anne Arundel County, Maryland",6145,114,103,89,14,11,468,429,429,177,39,982,967,928,239,15,854,854,782,295,0,3727,3727,3684,341,0
1400000US24003702204,"Census Tract 7022.04, Anne Arundel County, Maryland",4199,62,62,43,27,0,266,243,220,86,23,267,267,267,49,0,534,492,451,84,42,3070,2968,2917,372,102
1400000US24003702205,"Census Tract 7022.05, Anne Arundel County, Maryland",4883,163,134,54,134,29,242,229,218,79,13,941,859,775,204,82,725,669,669,115,56,2812,2763,2675,340,49
1400000US24003702206,"Census Tract 7022.06, Anne Arundel County, Maryland",6902,229,118,54,64,111,471,248,226,110,223,1266,1094,1070,156,172,1390,1293,1167,386,97,3546,3472,3329,300,74
1400000US24003702208,"Census Tract 7022.08, Anne Arundel County, Maryland",7277,18,18,0,18,0,393,294,294,32,99,1726,1203,1126,152,523,973,973,973,43,0,4167,4132,4048,206,35
1400000US24003702209,"Census Tract 7022.09, Anne Arundel County, Maryland",4351,277,234,147,87,43,333,333,333,8,0,193,88,88,42,105,199,199,199,0,0,3349,3309,3285,214,40
1400000US24003702300,"Census Tract 7023, Anne Arundel County, Maryland",5678,157,143,66,143,14,194,185,140,117,9,473,398,398,54,75,708,695,685,145,13,4146,4032,3866,621,114
1400000US24003702402,"Census Tract 7024.02, Anne Arundel County, Maryland",5890,383,383,259,315,0,468,468,468,248,0,773,548,411,277,225,1024,996,996,199,28,3242,3134,3067,748,108
1400000US24003702500,"Census Tract 7025, Anne Arundel County, Maryland",6678,623,524,97,485,99,1287,738,613,312,549,1576,1189,1055,188,387,566,535,495,161,31,2626,2330,2095,383,296
1400000US24003702601,"Census Tract 7026.01, Anne Arundel County, Maryland",5383,538,522,91,467,16,516,446,324,200,70,684,645,617,177,39,667,667,667,274,0,2978,2902,2838,443,76
1400000US24003702602,"Census Tract 7026.02, Anne Arundel County, Maryland",5856,235,220,207,109,15,212,212,177,135,0,561,561,474,282,0,655,640,620,213,15,4193,3870,3771,470,323
1400000US24003702701,"Census Tract 7027.01, Anne Arundel County, Maryland",4508,272,272,232,78,0,360,348,329,72,12,755,744,669,305,11,917,917,898,101,0,2204,2123,1979,286,81
1400000US24003702702,"Census Tract 7027.02, Anne Arundel County, Maryland",3572,97,97,97,56,0,211,191,180,157,20,339,323,287,118,16,252,252,235,94,0,2673,2630,2619,433,43
1400000US24003706101,"Census Tract 7061.01, Anne Arundel County, Maryland",3315,504,443,183,331,61,555,478,367,225,77,385,368,332,97,17,128,128,128,0,0,1743,1715,1698,328,28
1400000US24003706301,"Census Tract 7063.01, Anne Arundel County, Maryland",4095,440,383,256,269,57,450,353,288,280,97,988,862,798,183,126,378,332,332,114,46,1839,1548,1487,353,291
1400000US24003706302,"Census Tract 7063.02, Anne Arundel County, Maryland",3429,333,275,185,176,58,366,325,266,254,41,317,295,283,34,22,564,520,493,184,44,1849,1849,1822,391,0
1400000US24003706401,"Census Tract 7064.01, Anne Arundel County, Maryland",6377,545,213,107,126,332,1115,509,226,420,606,1970,1508,1237,464,462,1055,882,797,184,173,1692,1527,1371,279,165
1400000US24003706402,"Census Tract 7064.02, Anne Arundel County, Maryland",2843,872,795,158,702,77,435,391,260,240,44,451,398,369,122,53,259,226,222,39,33,826,826,776,151,0
1400000US24003706500,"Census Tract 7065, Anne Arundel County, Maryland",5258,681,507,408,296,174,612,426,296,191,186,1111,1080,1048,122,31,1156,996,974,146,160,1698,1501,1462,267,197
1400000US24003706600,"Census Tract 7066, Anne Arundel County, Maryland",5035,705,455,226,282,250,668,601,430,295,67,464,429,391,259,35,947,887,865,155,60,2251,2225,2176,262,26
1400000US24003706700,"Census Tract 7067, Anne Arundel County, Maryland",795,3,0,0,0,3,14,14,14,0,0,204,204,204,0,0,52,52,52,0,0,522,522,522,60,0
1400000US24003707001,"Census Tract 7070.01, Anne Arundel County, Maryland",6579,593,561,252,439,32,799,660,357,436,139,875,822,761,87,53,736,736,612,178,0,3576,3528,3447,471,48
1400000US24003707002,"Census Tract 7070.02, Anne Arundel County, Maryland",4462,166,166,98,121,0,595,510,399,187,85,432,432,422,108,0,881,792,722,193,89,2388,2328,2303,270,60
1400000US24003708001,"Census Tract 7080.01, Anne Arundel County, Maryland",3748,128,71,50,57,57,526,422,422,258,104,372,355,323,97,17,648,630,521,215,18,2074,2040,2040,244,34
1400000US24003708004,"Census Tract 7080.04, Anne Arundel County, Maryland",5570,828,670,129,628,158,815,645,440,419,170,788,661,434,314,127,766,725,688,52,41,2373,2253,2187,249,120
1400000US24003730100,"Census Tract 7301, Anne Arundel County, Maryland",6725,306,243,162,140,63,1115,794,724,216,321,896,863,703,198,33,1624,1397,1198,349,227,2784,2661,2567,276,123
1400000US24003730203,"Census Tract 7302.03, Anne Arundel County, Maryland",4784,946,806,371,628,140,1452,1301,608,832,151,1120,886,472,422,234,650,522,512,26,128,616,579,519,82,37
1400000US24003730204,"Census Tract 7302.04, Anne Arundel County, Maryland",6197,663,636,160,580,27,1298,1241,720,739,57,735,699,598,212,36,943,708,597,216,235,2558,2234,2214,197,324
1400000US24003730300,"Census Tract 7303, Anne Arundel County, Maryland",3100,726,534,163,513,192,352,278,209,211,74,649,606,474,198,43,735,681,367,342,54,638,619,596,96,19
1400000US24003730401,"Census Tract 7304.01, Anne Arundel County, Maryland",4164,549,454,202,356,95,505,478,314,221,27,1168,974,886,226,194,618,504,402,199,114,1324,1269,1259,159,55
1400000US24003730402,"Census Tract 7304.02, Anne Arundel County, Maryland",6028,1667,1265,258,1132,402,813,622,457,299,191,1214,990,775,432,224,1146,1034,1034,41,112,1188,1034,1015,79,154
1400000US24003730502,"Census Tract 7305.02, Anne Arundel County, Maryland",5883,671,507,222,342,164,933,794,633,304,139,656,635,594,245,21,861,759,719,213,102,2762,2660,2550,260,102
1400000US24003730504,"Census Tract 7305.04, Anne Arundel County, Maryland",7354,250,125,91,81,125,1818,1601,1193,648,217,1056,998,930,260,58,1179,1125,1082,73,54,3051,2965,2876,288,86
1400000US24003730505,"Census Tract 7305.05, Anne Arundel County, Maryland",4444,674,501,160,449,173,1229,780,448,436,449,1134,988,735,282,146,642,585,394,200,57,765,765,565,200,0
1400000US24003730506,"Census Tract 7305.06, Anne Arundel County, Maryland",4253,782,562,167,462,220,1382,1069,976,148,313,784,754,685,120,30,898,807,645,188,91,407,392,374,36,15
1400000US24003730601,"Census Tract 7306.01, Anne Arundel County, Maryland",6991,163,163,163,78,0,170,170,118,170,0,502,446,400,187,56,750,635,560,243,115,5406,5364,5316,544,42
1400000US24003730603,"Census Tract 7306.03, Anne Arundel County, Maryland",3720,162,133,112,101,29,178,145,135,54,33,340,296,287,80,44,566,545,537,19,21,2474,2461,2400,284,13
1400000US24003730604,"Census Tract 7306.04, Anne Arundel County, Maryland",6349,193,180,165,79,13,203,203,172,192,0,594,577,547,98,17,1003,1003,898,295,0,4356,4333,4305,371,23
1400000US24003730700,"Census Tract 7307, Anne Arundel County, Maryland",6741,354,319,274,192,35,474,376,255,254,98,829,783,751,203,46,679,654,618,130,25,4405,4287,4226,568,118
1400000US24003730800,"Census Tract 7308, Anne Arundel County, Maryland",2453,83,83,51,48,0,85,85,55,59,0,148,124,124,38,24,187,187,187,43,0,1950,1780,1746,282,170
1400000US24003730901,"Census Tract 7309.01, Anne Arundel County, Maryland",2432,26,26,22,20,0,235,199,132,117,36,190,110,81,73,80,216,216,204,43,0,1765,1752,1709,227,13
1400000US24003730902,"Census Tract 7309.02, Anne Arundel County, Maryland",3634,66,54,54,8,12,439,351,294,168,88,278,278,269,82,0,229,229,229,119,0,2622,2560,2553,288,62
1400000US24003731002,"Census Tract 7310.02, Anne Arundel County, Maryland",3204,83,67,60,52,16,193,150,102,91,43,657,533,513,174,124,461,437,413,171,24,1810,1792,1751,139,18
1400000US24003731003,"Census Tract 7310.03, Anne Arundel County, Maryland",4337,83,83,83,56,0,262,233,210,100,29,477,403,350,154,74,925,738,689,84,187,2590,2457,2451,230,133
1400000US24003731004,"Census Tract 7310.04, Anne Arundel County, Maryland",4192,317,317,165,238,0,292,283,283,34,9,461,379,349,54,82,719,593,561,164,126,2403,2403,2387,204,0
1400000US24003731102,"Census Tract 7311.02, Anne Arundel County, Maryland",7081,260,205,205,101,55,578,563,461,208,15,1178,1127,1077,279,51,1268,1219,1194,152,49,3797,3741,3696,406,56
1400000US24003731103,"Census Tract 7311.03, Anne Arundel County, Maryland",4859,196,137,125,34,59,473,473,354,262,0,828,528,416,213,300,610,610,573,49,0,2752,2720,2711,182,32
1400000US24003731104,"Census Tract 7311.04, Anne Arundel County, Maryland",4797,68,52,52,0,16,348,312,299,112,36,401,350,272,180,51,906,868,868,64,38,3074,3016,2887,237,58
1400000US24003731105,"Census Tract 7311.05, Anne Arundel County, Maryland",3302,101,94,59,94,7,275,253,234,106,22,591,517,431,192,74,458,430,430,121,28,1877,1795,1760,237,82
1400000US24003731201,"Census Tract 7312.01, Anne Arundel County, Maryland",6238,191,149,80,101,42,593,490,385,280,103,694,623,559,162,71,639,609,581,54,30,4121,4069,3964,554,52
1400000US24003731202,"Census Tract 7312.02, Anne Arundel County, Maryland",6743,520,445,276,342,75,714,661,553,258,53,959,959,877,306,0,868,828,715,211,40,3682,3635,3536,352,47
1400000US24003731203,"Census Tract 7312.03, Anne Arundel County, Maryland",7274,395,307,164,209,88,377,345,326,140,32,1303,1178,1004,347,125,987,932,881,228,55,4212,4159,4123,266,53
1400000US24003731204,"Census Tract 7312.04, Anne Arundel County, Maryland",5792,246,246,138,144,0,797,727,515,328,70,1002,883,659,334,119,493,456,413,103,37,3254,3220,3140,239,34
1400000US24003731303,"Census Tract 7313.03, Anne Arundel County, Maryland",6848,446,418,285,307,28,380,340,302,207,40,697,662,594,187,35,1298,1281,1251,354,17,4027,3973,3805,453,54
1400000US24003731306,"Census Tract 7313.06, Anne Arundel County, Maryland",6757,238,238,199,172,0,594,463,347,260,131,538,496,482,161,42,691,655,655,89,36,4696,4491,4262,758,205
1400000US24003731307,"Census Tract 7313.07, Anne Arundel County, Maryland",6168,160,145,125,51,15,498,325,253,171,173,1394,1248,1234,112,146,1346,1244,1125,175,102,2770,2680,2624,191,90
1400000US24003731308,"Census Tract 7313.08, Anne Arundel County, Maryland",3360,269,248,216,200,21,398,374,302,215,24,720,624,587,144,96,364,347,332,116,17,1609,1566,1483,206,43
1400000US24003731309,"Census Tract 7313.09, Anne Arundel County, Maryland",5517,225,225,89,201,0,930,690,332,479,240,1069,1038,808,342,31,964,943,943,76,21,2329,2162,2134,167,167
1400000US24003731310,"Census Tract 7313.10, Anne Arundel County, Maryland",5219,106,72,9,72,34,318,276,221,123,42,852,804,670,215,48,1212,1104,1042,150,108,2731,2525,2410,285,206
1400000US24003731311,"Census Tract 7313.11, Anne Arundel County, Maryland",8479,532,380,140,289,152,825,792,587,383,33,1105,1088,993,154,17,1761,1404,1311,210,357,4256,3619,3329,615,637
1400000US24003740102,"Census Tract 7401.02, Anne Arundel County, Maryland",6359,300,252,192,150,48,577,458,423,127,119,1124,1022,961,179,102,1123,1031,944,176,92,3235,3110,3046,291,125
1400000US24003740103,"Census Tract 7401.03, Anne Arundel County, Maryland",8447,428,411,298,206,17,387,366,333,105,21,1320,1239,1119,278,81,1089,1089,1079,216,0,5223,4750,4413,974,473
1400000US24003740104,"Census Tract 7401.04, Anne Arundel County, Maryland",7293,675,608,73,566,67,1055,601,466,155,454,916,847,809,67,69,1054,883,797,228,171,3593,3491,3257,600,102
1400000US24003740105,"Census Tract 7401.05, Anne Arundel County, Maryland",3535,446,416,157,259,30,744,680,380,373,64,1274,1208,987,277,66,292,173,173,9,119,779,779,769,169,0
1400000US24017851100,"Census Tract 8511, Charles County, Maryland",2743,91,81,52,41,10,295,227,152,179,68,262,253,212,114,9,312,298,286,83,14,1783,1736,1623,152,47
1400000US24017851200,"Census Tract 8512, Charles County, Maryland",4235,394,329,182,193,65,727,580,385,302,147,635,556,535,213,79,722,653,649,170,69,1757,1717,1690,129,40
1400000US24017851301,"Census Tract 8513.01, Charles County, Maryland",4338,91,91,82,42,0,315,248,166,186,67,517,517,504,176,0,407,369,369,47,38,3008,2750,2727,113,258
1400000US24017851302,"Census Tract 8513.02, Charles County, Maryland",3766,83,83,83,31,0,528,454,321,273,74,221,221,221,90,0,390,343,328,103,47,2544,2319,2281,208,225
1400000US24017851400,"Census Tract 8514, Charles County, Maryland",8692,484,327,92,292,157,386,260,128,165,126,656,638,573,206,18,1238,1006,944,152,232,5928,5741,5544,679,187
1400000US24017851500,"Census Tract 8515, Charles County, Maryland",7983,389,389,210,193,0,541,525,488,140,16,1975,1947,1731,401,28,1325,1325,1325,129,0,3753,3641,3631,296,112
1400000US24017990000,"Census Tract 9900, Charles County, Maryland",0,0,0,0,0,0,0,0,0,0,0,0,0,0,0,0,0,0,0,0,0,0,0,0,0,0
1400000US24019970100,"Census Tract 9701, Dorchester County, Maryland",2902,373,347,181,284,26,807,731,600,298,76,642,570,439,212,72,523,492,417,145,31,557,531,515,84,26
1400000US24019970200,"Census Tract 9702, Dorchester County, Maryland",4925,878,784,252,687,94,1171,1027,731,624,144,1188,1059,907,260,129,723,690,674,92,33,965,931,804,307,34
1400000US24019970300,"Census Tract 9703, Dorchester County, Maryland",4955,481,422,225,307,59,1098,931,680,427,167,812,677,547,274,135,1338,1273,1117,289,65,1226,1107,1032,234,119
1400000US24019970400,"Census Tract 9704, Dorchester County, Maryland",3027,716,593,236,493,123,1090,957,444,718,133,401,385,333,125,16,400,400,394,50,0,420,420,385,103,0
1400000US24019970500,"Census Tract 9705, Dorchester County, Maryland",3786,1808,1651,213,1646,157,1077,759,452,363,318,594,411,170,272,183,187,187,182,30,0,120,117,107,17,3
1400000US24019970600,"Census Tract 9706, Dorchester County, Maryland",4749,1155,972,284,819,183,1356,1177,661,769,179,894,759,520,297,135,670,593,531,164,77,674,652,563,132,22
1400000US24019970702,"Census Tract 9707.02, Dorchester County, Maryland",3992,531,429,169,366,102,1052,975,577,687,77,750,722,639,214,28,601,571,529,210,30,1058,931,873,185,127
1400000US24019970804,"Census Tract 9708.04, Dorchester County, Maryland",1798,206,192,101,169,14,395,360,309,149,35,394,393,373,81,1,240,231,204,89,9,563,403,403,58,160
1400000US24019970900,"Census Tract 9709, Dorchester County, Maryland",1779,394,333,234,294,61,411,411,274,260,0,364,228,191,82,136,177,177,177,22,0,433,394,342,144,39
1400000US24019990000,"Census Tract 9900, Dorchester County, Maryland",0,0,0,0,0,0,0,0,0,0,0,0,0,0,0,0,0,0,0,0,0,0,0,0,0,0
1400000US24021740200,"Census Tract 7402, Frederick County, Maryland",4631,190,154,116,128,36,557,508,370,205,49,1024,987,940,285,37,1040,1019,970,135,21,1820,1777,1740,150,43
1400000US24021750100,"Census Tract 7501, Frederick County, Maryland",1367,351,240,156,137,111,208,190,190,37,18,298,196,196,8,102,288,255,255,46,33,222,218,194,29,4
1400000US24021750200,"Census Tract 7502, Frederick County, Maryland",1405,96,96,58,49,0,297,220,173,96,77,240,218,203,36,22,293,238,238,33,55,479,479,461,75,0
1400000US24021750300,"Census Tract 7503, Frederick County, Maryland",1508,377,336,156,236,41,505,478,341,175,27,465,371,283,145,94,42,42,30,12,0,119,119,119,4,0
1400000US24021750503,"Census Tract 7505.03, Frederick County, Maryland",6374,768,623,113,524,145,1579,1107,552,677,472,1577,1006,779,319,571,1089,1059,1029,187,30,1361,1284,1180,194,77
1400000US24021750504,"Census Tract 7505.04, Frederick County, Maryland",5362,757,714,462,651,43,929,798,760,212,131,1048,1041,941,289,7,1349,772,662,185,577,1279,1238,1217,188,41
1400000US24021750505,"Census Tract 7505.05, Frederick County, Maryland",6070,787,469,103,399,318,1907,1198,595,609,709,2118,1739,1585,227,379,377,348,335,28,29,881,833,777,85,48
1400000US24021750506,"Census Tract 7505.06, Frederick County, Maryland",3932,51,43,23,31,8,556,362,196,166,194,827,708,482,257,119,396,365,354,23,31,2102,1980,1787,274,122
1400000US24021750600,"Census Tract 7506, Frederick County, Maryland",2067,132,123,85,111,9,287,264,238,124,23,240,240,229,120,0,352,327,279,143,25,1056,1021,967,222,35
1400000US24021750701,"Census Tract 7507.01, Frederick County, Maryland",5301,166,166,36,130,0,425,363,214,206,62,1084,1013,774,331,71,960,900,885,25,60,2666,2597,2286,413,69
1400000US24021750702,"Census Tract 7507.02, Frederick County, Maryland",3081,401,344,118,311,57,950,778,424,463,172,719,719,650,103,0,288,276,263,55,12,723,599,553,80,124
1400000US24021750801,"Census Tract 7508.01, Frederick County, Maryland",2866,521,470,221,357,51,606,515,409,200,91,493,485,467,61,8,385,366,366,40,19,861,809,764,119,52
1400000US24021750802,"Census Tract 7508.02, Frederick County, Maryland",3909,411,377,206,195,34,332,300,246,179,32,478,448,392,186,30,733,702,635,217,31,1955,1955,1943,310,0
1400000US24021750803,"Census Tract 7508.03, Frederick County, Maryland",6400,258,153,55,119,105,589,529,389,210,60,1133,1105,1041,192,28,1056,887,751,286,169,3364,2856,2775,192,508
1400000US24021751001,"Census Tract 7510.01, Frederick County, Maryland",1116,0,0,0,0,0,188,43,18,40,145,24,19,19,0,5,96,96,96,35,0,808,670,670,0,138
1400000US24021751002,"Census Tract 7510.02, Frederick County, Maryland",4708,355,339,187,266,16,508,440,399,122,68,946,859,784,227,87,739,728,699,29,11,2160,2087,1981,296,73
1400000US24021751003,"Census Tract 7510.03, Frederick County, Maryland",5181,462,412,177,352,50,1412,1152,697,662,260,944,876,795,257,68,864,772,772,56,92,1499,1388,1371,118,111
1400000US24021751004,"Census Tract 7510.04, Frederick County, Maryland",4138,190,104,17,87,86,421,388,332,109,33,458,458,432,52,0,862,826,807,50,36,2207,2065,1791,425,142
1400000US24021751201,"Census Tract 7512.01, Frederick County, Maryland",4499,165,165,165,58,0,565,565,551,186,0,680,680,532,163,0,486,443,344,126,43,2603,2568,2509,496,35
1400000US24021751202,"Census Tract 7512.02, Frederick County, Maryland",5866,591,519,159,463,72,478,436,334,281,42,930,914,842,128,16,608,608,529,128,0,3259,3219,3100,303,40
1400000US24021751203,"Census Tract 7512.03, Frederick County, Maryland",1692,126,102,48,102,24,458,373,344,184,85,377,342,254,174,35,281,281,261,73,0,450,450,437,84,0
1400000US24021751301,"Census Tract 7513.01, Frederick County, Maryland",2781,75,75,75,57,0,363,302,262,145,61,623,566,418,243,57,369,369,355,90,0,1351,1272,1210,258,79
1400000US24021751302,"Census Tract 7513.02, Frederick County, Maryland",2765,341,228,89,186,113,277,269,216,132,8,547,457,401,143,90,677,677,670,264,0,923,909,887,158,14
1400000US24021751600,"Census Tract 7516, Frederick County, Maryland",2953,178,178,146,82,0,253,252,252,128,1,562,451,383,134,111,500,458,439,86,42,1460,1411,1367,260,49
1400000US24021751701,"Census Tract 7517.01, Frederick County, Maryland",2421,83,83,31,73,0,366,350,320,95,16,313,306,292,39,7,209,209,185,51,0,1450,1431,1390,153,19
1400000US24021751702,"Census Tract 7517.02, Frederick County, Maryland",3756,248,241,181,96,7,104,104,82,30,0,454,444,436,75,10,628,576,576,67,52,2322,2277,2180,247,45
1400000US24021751801,"Census Tract 7518.01, Frederick County, Maryland",4149,222,211,161,72,11,253,241,236,49,12,599,466,329,178,133,422,422,393,52,0,2653,2621,2480,381,32
1400000US24021751802,"Census Tract 7518.02, Frederick County, Maryland",3956,133,119,30,104,14,585,356,191,249,229,436,419,345,204,17,470,459,433,142,11,2332,2303,2248,142,29
1400000US24021751901,"Census Tract 7519.01, Frederick County, Maryland",4216,310,204,33,195,106,198,137,116,44,61,356,356,323,130,0,666,650,642,82,16,2686,2647,2629,146,39
1400000US24021751902,"Census Tract 7519.02, Frederick County, Maryland",5776,456,456,260,282,0,704,662,596,313,42,449,426,359,123,23,882,868,839,67,14,3285,3206,3135,215,79
1400000US24021751903,"Census Tract 7519.03, Frederick County, Maryland",6429,227,110,98,57,117,198,198,103,171,0,563,544,525,237,19,1084,878,853,151,206,4357,4347,4261,241,10
1400000US24021751904,"Census Tract 7519.04, Frederick County, Maryland",3037,110,98,50,74,12,270,270,212,112,0,293,293,293,30,0,278,255,238,56,23,2086,2002,1975,150,84
1400000US24021752001,"Census Tract 7520.01, Frederick County, Maryland",4744,124,111,98,111,13,460,460,404,146,0,336,327,319,32,9,911,894,837,188,17,2913,2861,2846,180,52
1400000US24021752101,"Census Tract 7521.01, Frederick County, Maryland",3443,35,35,35,25,0,168,153,108,147,15,174,143,108,70,31,218,218,218,17,0,2848,2811,2794,90,37
1400000US24021752102,"Census Tract 7521.02, Frederick County, Maryland",4582,83,71,36,49,12,497,497,331,363,0,487,420,376,80,67,550,543,520,56,7,2965,2698,2649,275,267
1400000US24021752201,"Census Tract 7522.01, Frederick County, Maryland",2383,99,93,68,51,6,344,281,158,201,63,199,184,184,74,15,316,316,316,45,0,1425,1355,1355,127,70
1400000US24021752202,"Census Tract 7522.02, Frederick County, Maryland",3619,6,6,6,0,0,377,300,206,153,77,740,740,707,64,0,565,547,509,76,18,1931,1917,1900,40,14
1400000US24021752204,"Census Tract 7522.04, Frederick County, Maryland",5763,162,85,46,39,77,452,333,333,35,119,245,245,226,52,0,720,688,688,77,32,4184,4033,3912,298,151
1400000US24021752301,"Census Tract 7523.01, Frederick County, Maryland",4303,406,319,185,134,87,446,442,315,179,4,635,635,612,102,0,614,583,503,94,31,2202,2103,2077,68,99
1400000US24021752302,"Census Tract 7523.02, Frederick County, Maryland",3939,112,102,71,91,10,671,606,392,341,65,468,317,219,216,151,399,345,312,97,54,2289,2236,2230,145,53
1400000US24021752303,"Census Tract 7523.03, Frederick County, Maryland",2615,67,58,41,36,9,293,276,254,96,17,237,165,146,38,72,469,469,469,14,0,1549,1524,1513,143,25
1400000US24021752501,"Census Tract 7525.01, Frederick County, Maryland",4783,260,260,191,190,0,384,374,357,145,10,879,782,660,223,97,723,723,720,127,0,2537,2525,2483,112,12
1400000US24021752502,"Census Tract 7525.02, Frederick County, Maryland",2573,42,42,17,42,0,424,403,382,180,21,89,76,48,43,13,511,508,508,49,3,1507,1478,1417,145,29
1400000US24021752601,"Census Tract 7526.01, Frederick County, Maryland",3820,106,106,58,85,0,230,183,162,111,47,329,287,237,156,42,474,446,351,139,28,2681,2665,2650,126,16
1400000US24021752602,"Census Tract 7526.02, Frederick County, Maryland",2738,143,127,96,82,16,247,231,190,116,16,387,338,261,155,49,555,537,508,53,18,1406,1389,1357,119,17
1400000US24021752603,"Census Tract 7526.03, Frederick County, Maryland",4039,16,16,0,16,0,289,232,113,179,57,478,431,405,77,47,596,596,562,167,0,2660,2605,2579,221,55
1400000US24021752801,"Census Tract 7528.01, Frederick County, Maryland",2169,126,126,75,121,0,411,405,385,104,6,240,240,240,55,0,577,520,486,44,57,815,815,809,44,0
1400000US24021752802,"Census Tract 7528.02, Frederick County, Maryland",3539,163,153,110,132,10,322,262,236,99,60,575,508,451,127,67,489,429,425,92,60,1990,1907,1842,211,83
1400000US24021752900,"Census Tract 7529, Frederick County, Maryland",2990,390,338,222,180,52,324,308,262,150,16,538,491,359,180,47,476,476,476,57,0,1262,1186,1136,79,76
1400000US24021753001,"Census Tract 7530.01, Frederick County, Maryland",4853,454,243,101,215,211,686,616,444,349,70,792,783,573,352,9,894,851,704,206,43,2027,1988,1988,96,39
1400000US24021753002,"Census Tract 7530.02, Frederick County, Maryland",2733,241,224,157,129,17,413,329,303,107,84,492,454,419,111,38,280,257,257,36,23,1307,1274,1226,70,33
1400000US24021765100,"Census Tract 7651, Frederick County, Maryland",3915,751,678,122,632,73,1166,896,459,575,270,679,629,555,204,50,404,386,344,111,18,915,806,797,145,109
1400000US24021766800,"Census Tract 7668, Frederick County, Maryland",3565,687,642,240,551,45,558,532,300,330,26,793,730,667,124,63,359,350,345,75,9,1168,1068,1040,103,100
1400000US24021767500,"Census Tract 7675, Frederick County, Maryland",2921,269,201,113,106,68,438,383,303,198,55,652,568,485,173,84,581,502,469,148,79,981,937,909,57,44
1400000US24021767600,"Census Tract 7676, Frederick County, Maryland",3576,215,188,119,152,27,658,457,335,222,201,580,545,498,109,35,548,501,423,130,47,1575,1567,1526,159,8
1400000US24021770700,"Census Tract 7707, Frederick County, Maryland",3392,220,190,128,122,30,401,345,292,151,56,428,428,408,146,0,471,380,354,60,91,1872,1731,1714,94,141
1400000US24021772200,"Census Tract 7722, Frederick County, Maryland",1988,276,239,33,221,37,625,566,291,301,59,538,454,300,198,84,86,49,45,15,37,463,463,448,77,0
1400000US24021773500,"Census Tract 7735, Frederick County, Maryland",4558,408,336,228,215,72,385,352,271,95,33,600,508,340,207,92,1042,954,894,165,88,2123,1833,1720,316,290
1400000US24021775302,"Census Tract 7753.02, Frederick County, Maryland",4270,74,52,24,35,22,334,250,103,220,84,874,801,706,185,73,1041,881,816,140,160,1947,1824,1764,194,123
1400000US24021775400,"Census Tract 7754, Frederick County, Maryland",3629,531,502,318,373,29,642,550,344,288,92,466,421,343,125,45,846,653,625,55,193,1144,1113,1094,63,31
1400000US24021775600,"Census Tract 7756, Frederick County, Maryland",3641,36,36,36,36,0,270,246,65,208,24,489,389,355,45,100,757,724,724,69,33,2089,2071,2052,167,18
1400000US24023000100,"Census Tract 1, Garrett County, Maryland",3736,947,810,279,756,137,651,469,421,156,182,1042,942,841,198,100,604,599,579,73,5,492,451,445,32,41
1400000US24023000200,"Census Tract 2, Garrett County, Maryland",4021,668,437,137,397,231,1009,882,656,445,127,1146,926,816,222,220,572,385,377,57,187,626,601,507,101,25
1400000US24023000300,"Census Tract 3, Garrett County, Maryland",2738,307,182,96,130,125,818,639,449,376,179,511,491,438,127,20,628,607,607,59,21,474,460,451,93,14
1400000US24023000400,"Census Tract 4, Garrett County, Maryland",3070,504,406,151,385,98,891,719,472,398,172,843,796,617,318,47,611,545,447,147,66,221,203,201,50,18
1400000US24023000500,"Census Tract 5, Garrett County, Maryland",3874,644,556,305,350,88,968,719,381,508,249,407,345,317,231,62,639,578,525,162,61,1216,1174,1126,331,42
1400000US24023000600,"Census Tract 6, Garrett County, Maryland",6119,1002,754,357,552,248,2236,1954,924,1388,282,939,847,686,264,92,657,629,600,147,28,1285,1205,1165,110,80
1400000US24023000700,"Census Tract 7, Garrett County, Maryland",5847,1724,1394,383,1267,330,1391,1145,666,711,246,914,720,631,165,194,816,622,508,121,194,1002,875,695,241,127
1400000US24025301102,"Census Tract 3011.02, Harford County, Maryland",3631,289,233,89,171,56,391,318,202,214,73,273,256,245,33,17,382,338,338,118,44,2296,2187,2050,379,109
1400000US24025301105,"Census Tract 3011.05, Harford County, Maryland",4250,224,224,31,193,0,84,84,53,31,0,671,671,597,139,0,1336,1318,1304,47,18,1935,1806,1755,223,129
1400000US24025301106,"Census Tract 3011.06, Harford County, Maryland",4170,328,239,188,51,89,271,241,215,148,30,435,409,361,155,26,655,607,593,123,48,2481,2435,2412,114,46
1400000US24025301107,"Census Tract 3011.07, Harford County, Maryland",3009,443,410,236,305,33,330,266,227,204,64,795,767,737,94,28,430,430,413,37,0,1011,994,994,0,17
1400000US24025301108,"Census Tract 3011.08, Harford County, Maryland",3380,94,42,42,21,52,121,100,65,69,21,338,338,338,75,0,474,459,459,33,15,2353,2311,2284,87,42
1400000US24025301201,"Census Tract 3012.01, Harford County, Maryland",2129,88,88,76,50,0,424,379,321,167,45,506,467,388,194,39,254,235,235,35,19,857,824,803,168,33
1400000US24025301202,"Census Tract 3012.02, Harford County, Maryland",7076,350,312,253,59,38,714,550,442,258,164,718,541,470,218,177,1121,1070,1070,99,51,4173,4028,3943,247,145
1400000US24025301204,"Census Tract 3012.04, Harford County, Maryland",4183,19,19,19,19,0,651,616,616,61,35,1061,1061,977,190,0,569,483,432,67,86,1883,1883,1857,111,0
1400000US24025301205,"Census Tract 3012.05, Harford County, Maryland",3807,272,261,152,204,11,732,704,525,271,28,476,467,428,110,9,841,841,830,83,0,1486,1415,1389,68,71
1400000US24025301301,"Census Tract 3013.01, Harford County, Maryland",5043,633,592,272,436,41,474,441,273,326,33,1011,987,907,258,24,575,517,482,138,58,2350,2126,1891,369,224
1400000US24025301302,"Census Tract 3013.02, Harford County, Maryland",7145,1886,1580,53,1580,306,1770,1632,977,865,138,1113,879,645,284,234,1744,1697,1622,348,47,632,577,577,6,55
1400000US24025301401,"Census Tract 3014.01, Harford County, Maryland",7560,893,863,508,458,30,1128,981,753,560,147,1383,1361,1345,175,22,1619,1508,1366,303,111,2537,2490,2328,421,47
1400000US24025301402,"Census Tract 3014.02, Harford County, Maryland",2200,83,72,32,61,11,294,279,187,134,15,417,402,402,114,15,567,467,438,55,100,839,815,801,73,24
1400000US24025301601,"Census Tract 3016.01, Harford County, Maryland",6245,872,712,66,703,160,2163,1980,1328,1011,183,1263,1058,771,322,205,1443,1443,1351,195,0,504,478,418,120,26
1400000US24025301602,"Census Tract 3016.02, Harford County, Maryland",7808,932,867,556,448,65,1555,1158,855,477,397,1664,1254,934,520,410,1170,1087,913,209,83,2487,2345,2292,385,142
1400000US24025301702,"Census Tract 3017.02, Harford County, Maryland",7946,542,313,173,205,229,631,599,539,299,32,1820,1689,1414,580,131,1150,1131,928,423,19,3803,3653,3441,555,150
1400000US24025301703,"Census Tract 3017.03, Harford County, Maryland",4785,327,261,242,130,66,537,498,338,232,39,584,539,470,104,45,986,927,816,127,59,2351,2242,2173,280,109
1400000US24025301704,"Census Tract 3017.04, Harford County, Maryland",3624,343,265,68,205,78,613,585,292,341,28,841,810,810,53,31,1005,992,965,65,13,822,797,797,57,25
1400000US24025302100,"Census Tract 3021, Harford County, Maryland",2284,272,200,30,177,72,295,255,212,111,40,387,382,302,148,5,417,405,350,147,12,913,913,879,116,0
1400000US24025302200,"Census Tract 3022, Harford County, Maryland",2437,237,216,113,188,21,613,511,423,236,102,249,206,186,74,43,441,412,380,94,29,897,829,796,146,68
1400000US24025302400,"Census Tract 3024, Harford County, Maryland",2513,422,377,198,267,45,565,513,359,321,52,588,519,507,38,69,264,232,217,36,32,674,575,544,93,99
1400000US24025302801,"Census Tract 3028.01, Harford County, Maryland",3868,282,250,45,250,32,685,620,438,276,65,851,843,749,206,8,597,526,462,154,71,1453,1412,1379,267,41
1400000US24025302802,"Census Tract 3028.02, Harford County, Maryland",4687,606,493,193,448,113,996,773,658,303,223,1241,1069,902,272,172,971,905,595,431,66,873,716,647,284,157
1400000US24025302901,"Census Tract 3029.01, Harford County, Maryland",2685,1046,892,294,651,154,704,483,383,191,221,473,397,275,144,76,113,113,94,19,0,349,281,257,88,68
1400000US24025302902,"Census Tract 3029.02, Harford County, Maryland",4625,660,640,177,600,20,1064,909,732,334,155,1073,941,759,299,132,559,494,471,74,65,1269,1178,1167,247,91
1400000US24025303101,"Census Tract 3031.01, Harford County, Maryland",6269,415,275,200,248,140,729,640,311,491,89,492,413,363,116,79,1132,1075,984,199,57,3501,3468,3453,60,33
1400000US24025303102,"Census Tract 3031.02, Harford County, Maryland",3048,18,13,13,0,5,115,115,115,5,0,409,398,381,58,11,651,637,616,127,14,1855,1828,1823,263,27
1400000US24025303201,"Census Tract 3032.01, Harford County, Maryland",5706,240,230,160,107,10,354,348,272,155,6,646,631,603,119,15,1021,934,793,292,87,3445,3306,3186,298,139
1400000US24025303203,"Census Tract 3032.03, Harford County, Maryland",3264,126,126,102,126,0,297,252,252,149,45,493,463,435,135,30,688,675,636,212,13,1660,1645,1574,221,15
1400000US24025303204,"Census Tract 3032.04, Harford County, Maryland",4858,402,397,383,97,5,765,721,705,328,44,654,625,598,114,29,702,603,559,93,99,2335,2277,2253,112,58
1400000US24025303205,"Census Tract 3032.05, Harford County, Maryland",1686,86,66,56,42,20,128,92,92,36,36,79,79,74,15,0,82,82,82,27,0,1311,1305,1218,162,6
1400000US24025303206,"Census Tract 3032.06, Harford County, Maryland",3164,50,50,43,21,0,260,260,233,138,0,591,557,557,99,34,509,509,482,63,0,1754,1694,1667,156,60
1400000US24025303300,"Census Tract 3033, Harford County, Maryland",5776,156,156,140,57,0,351,339,312,180,12,832,819,716,343,13,1343,1343,1343,285,0,3094,2914,2898,247,180
1400000US24025303400,"Census Tract 3034, Harford County, Maryland",4362,161,161,126,115,0,459,408,344,266,51,417,395,337,213,22,810,789,740,101,21,2515,2465,2441,311,50
1400000US24025303501,"Census Tract 3035.01, Harford County, Maryland",5953,553,553,441,467,0,484,465,431,171,19,771,709,667,215,62,852,834,802,213,18,3293,3235,3124,514,58
1400000US24025303502,"Census Tract 3035.02, Harford County, Maryland",3542,40,22,22,22,18,298,282,282,96,16,367,351,302,65,16,1013,883,846,122,130,1824,1797,1797,59,27
1400000US24025303602,"Census Tract 3036.02, Harford County, Maryland",3331,315,285,263,96,30,235,235,182,107,0,567,546,546,239,21,274,265,265,34,9,1940,1855,1796,193,85
1400000US24025303603,"Census Tract 3036.03, Harford County, Maryland",6914,166,144,144,85,22,386,386,386,84,0,946,807,621,271,139,832,778,739,80,54,4584,4432,4347,355,152
1400000US24025303605,"Census Tract 3036.05, Harford County, Maryland",5557,739,660,261,534,79,662,612,531,226,50,869,809,763,349,60,859,827,807,129,32,2428,2246,2171,222,182
1400000US24025303606,"Census Tract 3036.06, Harford County, Maryland",3467,31,11,11,11,20,100,100,93,17,0,130,130,130,31,0,569,553,553,44,16,2637,2579,2579,159,58
1400000US24025303700,"Census Tract 3037, Harford County, Maryland",3711,281,257,137,224,24,479,479,374,240,0,1023,937,888,307,86,599,568,568,109,31,1329,1315,1315,113,14
1400000US24025303801,"Census Tract 3038.01, Harford County, Maryland",2459,411,308,89,290,103,562,549,502,258,13,239,239,222,94,0,328,280,253,51,48,919,883,883,127,36
1400000US24025303802,"Census Tract 3038.02, Harford County, Maryland",1402,207,207,192,95,0,494,388,267,213,106,149,135,127,36,14,77,77,77,4,0,475,475,475,63,0
1400000US24025303803,"Census Tract 3038.03, Harford County, Maryland",4756,339,339,205,275,0,708,696,556,395,12,1036,1036,1036,148,0,652,638,616,176,14,2021,1998,1962,181,23
1400000US24025303900,"Census Tract 3039, Harford County, Maryland",2308,223,217,146,137,6,438,336,314,141,102,414,354,281,211,60,249,249,249,53,0,984,984,971,112,0
1400000US24025304101,"Census Tract 3041.01, Harford County, Maryland",4542,178,167,89,103,11,425,391,311,146,34,918,901,874,216,17,1081,1072,1013,200,9,1940,1940,1881,270,0
1400000US24025304102,"Census Tract 3041.02, Harford County, Maryland",3671,64,50,50,18,14,238,234,216,164,4,582,520,490,86,62,585,585,561,157,0,2202,2103,2011,127,99
1400000US24025304201,"Census Tract 3042.01, Harford County, Maryland",6317,427,150,72,126,277,489,455,359,214,34,634,604,553,160,30,751,741,710,233,10,4016,4005,3854,586,11
1400000US24025304202,"Census Tract 3042.02, Harford County, Maryland",7144,559,559,378,424,0,615,502,296,328,113,814,790,732,207,24,1542,1346,1258,244,196,3614,3490,3423,211,124
1400000US24025305100,"Census Tract 3051, Harford County, Maryland",7021,688,662,397,463,26,893,844,734,292,49,984,896,810,256,88,470,426,426,63,44,3986,3830,3605,386,156
1400000US24025305200,"Census Tract 3052, Harford County, Maryland",2764,308,221,84,185,87,568,545,465,238,23,552,467,413,166,85,278,209,209,40,69,1058,929,904,134,129
1400000US24025305300,"Census Tract 3053, Harford County, Maryland",2152,274,215,135,127,59,330,312,277,133,18,540,496,399,160,44,329,296,209,110,33,679,672,666,139,7
1400000US24025306100,"Census Tract 3061, Harford County, Maryland",3916,1312,1076,453,814,236,599,489,434,275,110,538,476,391,159,62,764,704,645,88,60,703,678,668,115,25
1400000US24025306200,"Census Tract 3062, Harford County, Maryland",2182,540,497,293,368,43,356,301,273,121,55,647,544,479,86,103,181,83,64,46,98,458,437,388,98,21
1400000US24025306300,"Census Tract 3063, Harford County, Maryland",2195,140,125,63,76,15,254,215,203,177,39,204,204,204,53,0,453,432,410,84,21,1144,1115,1030,203,29
1400000US24025306400,"Census Tract 3064, Harford County, Maryland",6362,245,245,181,117,0,536,479,391,228,57,986,904,645,441,82,1240,1093,1045,163,147,3355,3301,3217,251,54
1400000US24025306500,"Census Tract 3065, Harford County, Maryland",1605,74,74,14,60,0,353,353,288,101,0,530,530,455,122,0,392,385,385,43,7,256,256,256,43,0
1400000US24027601103,"Census Tract 6011.03, Howard County, Maryland",5605,180,115,102,13,65,283,215,162,112,68,772,772,727,217,0,533,533,524,66,0,3837,3465,3405,312,372
1400000US24027601104,"Census Tract 6011.04, Howard County, Maryland",6261,45,45,45,0,0,214,196,196,14,18,341,341,341,33,0,769,706,644,84,63,4892,4780,4766,220,112
1400000US24027601105,"Census Tract 6011.05, Howard County, Maryland",3765,95,52,52,9,43,434,391,387,40,43,469,429,417,23,40,465,441,441,39,24,2302,2243,2149,154,59
1400000US24027601107,"Census Tract 6011.07, Howard County, Maryland",4634,632,573,185,500,59,315,214,171,113,101,1831,1243,971,382,588,539,517,485,43,22,1317,1241,1232,18,76
1400000US24027601108,"Census Tract 6011.08, Howard County, Maryland",3641,42,42,29,28,0,238,217,174,88,21,584,584,525,142,0,551,551,525,36,0,2226,2174,2136,132,52
1400000US24027601201,"Census Tract 6012.01, Howard County, Maryland",7556,257,257,114,188,0,1204,1045,756,484,159,1197,997,976,97,200,911,911,891,81,0,3987,3939,3873,220,48
1400000US24027601203,"Census Tract 6012.03, Howard County, Maryland",2481,190,111,0,111,79,63,63,63,0,0,336,297,297,0,39,274,221,221,6,53,1618,1546,1483,176,72
1400000US24027601204,"Census Tract 6012.04, Howard County, Maryland",4813,207,162,107,120,45,813,770,472,427,43,775,704,565,168,71,686,655,598,57,31,2332,2260,2248,85,72
1400000US24027602100,"Census Tract 6021, Howard County, Maryland",8126,137,117,56,74,20,209,209,209,59,0,587,587,516,270,0,429,429,429,136,0,6764,6442,6408,292,322
1400000US24027602201,"Census Tract 6022.01, Howard County, Maryland",3255,14,14,14,14,0,272,233,186,139,39,102,102,79,42,0,249,249,218,117,0,2618,2547,2518,238,71
1400000US24027602202,"Census Tract 6022.02, Howard County, Maryland",5260,156,156,29,137,0,715,664,454,378,51,384,338,283,231,46,681,542,542,59,139,3324,3324,3265,293,0
1400000US24027602302,"Census Tract 6023.02, Howard County, Maryland",6323,701,537,339,271,164,241,225,138,152,16,605,598,513,236,7,1041,917,860,126,124,3735,3690,3633,302,45
1400000US24027602303,"Census Tract 6023.03, Howard County, Maryland",3892,83,73,57,41,10,155,155,102,53,0,361,349,279,78,12,125,125,125,22,0,3168,3075,3000,277,93
1400000US24027602304,"Census Tract 6023.04, Howard County, Maryland",4997,60,60,60,37,0,223,223,223,88,0,410,344,301,198,66,370,346,305,121,24,3934,3919,3855,398,15
1400000US24027602305,"Census Tract 6023.05, Howard County, Maryland",3797,43,43,35,43,0,170,145,145,39,25,128,128,120,65,0,538,538,538,105,0,2918,2865,2840,162,53
1400000US24027602306,"Census Tract 6023.06, Howard County, Maryland",5159,323,192,146,95,131,401,401,303,302,0,702,687,687,182,15,731,714,699,198,17,3002,3002,2978,333,0
1400000US24027602600,"Census Tract 6026, Howard County, Maryland",6707,452,418,86,404,34,1226,868,649,331,358,1612,1222,1165,185,390,1001,909,873,126,92,2416,2173,2170,175,243
1400000US24027602700,"Census Tract 6027, Howard County, Maryland",5049,64,64,51,64,0,221,195,152,123,26,354,313,282,152,41,202,202,202,80,0,4208,4153,4077,285,55
1400000US24027602800,"Census Tract 6028, Howard County, Maryland",5932,365,329,118,248,36,352,287,259,165,65,594,433,332,198,161,1009,953,935,82,56,3612,3306,3293,70,306
1400000US24027602900,"Census Tract 6029, Howard County, Maryland",4248,401,308,258,153,93,644,252,202,88,392,794,564,530,66,230,614,524,524,51,90,1795,1756,1685,169,39
1400000US24027603001,"Census Tract 6030.01, Howard County, Maryland",5329,33,21,0,21,12,407,407,213,330,0,475,401,360,195,74,608,608,601,208,0,3806,3578,3578,219,228
1400000US24027603003,"Census Tract 6030.03, Howard County, Maryland",4142,129,113,101,12,16,267,252,230,70,15,475,475,438,167,0,414,403,350,137,11,2857,2857,2857,269,0
1400000US24027603004,"Census Tract 6030.04, Howard County, Maryland",6506,63,63,32,53,0,306,156,156,46,150,344,344,344,150,0,728,603,603,76,125,5065,4777,4679,641,288
1400000US24027604001,"Census Tract 6040.01, Howard County, Maryland",6047,61,61,61,10,0,408,375,312,209,33,392,369,369,86,23,936,936,866,218,0,4250,4071,3952,339,179
1400000US24027604002,"Census Tract 6040.02, Howard County, Maryland",7697,120,106,55,67,14,481,471,395,198,10,427,389,269,208,38,592,523,469,149,69,6077,5984,5903,279,93
1400000US24027605102,"Census Tract 6051.02, Howard County, Maryland",8156,234,191,158,73,43,254,244,177,182,10,277,277,231,93,0,999,997,996,168,2,6392,6303,6216,602,89
1400000US24027605103,"Census Tract 6051.03, Howard County, Maryland",4964,60,54,54,0,6,311,297,278,122,14,242,193,170,71,49,228,216,205,105,12,4123,4038,3949,384,85
1400000US24027605104,"Census Tract 6051.04, Howard County, Maryland",4559,46,46,0,46,0,145,145,145,10,0,116,103,91,55,13,253,253,253,41,0,3999,3959,3822,524,40
1400000US24027605401,"Census Tract 6054.01, Howard County, Maryland",4965,421,301,175,149,120,458,429,323,189,29,865,742,657,183,123,634,634,601,185,0,2587,2587,2556,290,0
1400000US24027605402,"Census Tract 6054.02, Howard County, Maryland",6853,559,435,329,322,124,1276,1070,920,498,206,1058,1058,990,171,0,1035,1027,911,240,8,2925,2805,2699,525,120
1400000US24027605502,"Census Tract 6055.02, Howard County, Maryland",5404,300,300,289,92,0,170,170,137,96,0,514,514,514,122,0,645,613,607,158,32,3775,3712,3602,570,63
1400000US24027605503,"Census Tract 6055.03, Howard County, Maryland",5919,410,361,95,312,49,1227,937,636,427,290,793,782,769,265,11,915,764,492,368,151,2574,2467,2356,324,107
1400000US24027605504,"Census Tract 6055.04, Howard County, Maryland",2812,0,0,0,0,0,130,130,130,0,0,103,86,53,44,17,137,88,88,32,49,2442,2386,2367,196,56
1400000US24027605505,"Census Tract 6055.05, Howard County, Maryland",6047,239,211,196,42,28,392,332,227,182,60,237,228,228,75,9,263,212,212,54,51,4916,4868,4787,265,48
1400000US24027605601,"Census Tract 6056.01, Howard County, Maryland",5944,307,256,182,196,51,926,905,876,100,21,1063,933,930,112,130,827,524,513,77,303,2821,2684,2684,233,137
1400000US24027605602,"Census Tract 6056.02, Howard County, Maryland",6527,336,320,154,247,16,345,280,191,138,65,479,468,468,53,11,800,764,764,179,36,4567,4467,4282,595,100
1400000US24027606601,"Census Tract 6066.01, Howard County, Maryland",3063,35,35,6,35,0,199,122,114,76,77,465,423,400,81,42,352,352,344,80,0,2012,1982,1867,435,30
1400000US24027606603,"Census Tract 6066.03, Howard County, Maryland",8151,649,411,226,301,238,1781,1377,766,698,404,994,836,768,232,158,1735,1581,1499,219,154,2992,2808,2778,318,184
1400000US24027606604,"Census Tract 6066.04, Howard County, Maryland",4000,183,147,43,104,36,296,253,185,110,43,746,634,412,291,112,999,779,658,189,220,1776,1697,1682,80,79
1400000US24027606606,"Census Tract 6066.06, Howard County, Maryland",4358,424,395,149,282,29,768,712,566,205,56,687,595,499,172,92,477,412,380,102,65,2002,1922,1867,123,80
1400000US24027606607,"Census Tract 6066.07, Howard County, Maryland",4629,145,91,79,22,54,117,117,100,58,0,417,328,235,199,89,622,561,492,193,61,3328,3242,3153,369,86
1400000US24027606701,"Census Tract 6067.01, Howard County, Maryland",2714,21,21,17,21,0,62,62,39,32,0,116,87,87,38,29,365,355,320,119,10,2150,2105,2080,213,45
1400000US24027606704,"Census Tract 6067.04, Howard County, Maryland",7905,699,603,333,496,96,850,700,516,362,150,688,513,487,213,175,1530,1360,1248,202,170,4138,3590,3477,421,548
1400000US24027606705,"Census Tract 6067.05, Howard County, Maryland",2139,60,60,25,60,0,192,187,139,96,5,356,220,200,73,136,361,318,285,60,43,1170,1149,1131,88,21
1400000US24027606706,"Census Tract 6067.06, Howard County, Maryland",4877,163,163,118,134,0,181,181,94,141,0,594,519,473,136,75,592,579,560,70,13,3347,3228,3194,292,119
1400000US24027606707,"Census Tract 6067.07, Howard County, Maryland",3830,441,407,193,364,34,116,87,61,31,29,782,612,592,46,170,456,456,456,6,0,2035,1884,1805,98,151
1400000US24027606803,"Census Tract 6068.03, Howard County, Maryland",5628,377,352,271,127,25,444,415,149,279,29,920,852,835,57,68,781,680,602,143,101,3106,3067,2990,180,39
1400000US24027606804,"Census Tract 6068.04, Howard County, Maryland",3260,63,63,43,20,0,321,321,282,60,0,358,322,301,34,36,383,372,372,25,11,2135,2060,2011,143,75
1400000US24027606805,"Census Tract 6068.05, Howard County, Maryland",4139,119,105,105,91,14,207,207,171,56,0,74,28,18,20,46,252,220,220,13,32,3487,3370,3295,276,117
1400000US24027606806,"Census Tract 6068.06, Howard County, Maryland",6296,196,136,91,102,60,200,183,183,44,17,1139,1098,1063,110,41,201,162,150,61,39,4560,4453,4291,390,107
1400000US24027606901,"Census Tract 6069.01, Howard County, Maryland",5078,398,244,110,212,154,992,882,550,391,110,737,586,532,104,151,974,954,954,38,20,1977,1754,1711,105,223
1400000US24027606904,"Census Tract 6069.04, Howard County, Maryland",4193,157,157,10,157,0,749,488,288,226,261,649,587,477,214,62,847,831,814,17,16,1791,1710,1686,50,81
1400000US24027606905,"Census Tract 6069.05, Howard County, Maryland",6445,360,322,137,200,38,807,741,538,338,66,1004,885,778,205,119,611,600,600,73,11,3663,3547,3434,265,116
1400000US24027606906,"Census Tract 6069.06, Howard County, Maryland",5623,78,78,51,51,0,456,420,334,113,36,1369,1012,811,266,357,1014,984,783,264,30,2706,2388,2318,192,318
1400000US24027606907,"Census Tract 6069.07, Howard County, Maryland",4778,120,120,92,49,0,843,501,424,131,342,1114,687,515,191,427,531,513,429,84,18,2170,2018,1870,179,152
1400000US24029950100,"Census Tract 9501, Kent County, Maryland",4063,329,261,115,218,68,582,417,260,292,165,1162,976,704,457,186,631,584,443,242,47,1359,1150,1117,119,209
1400000US24029950200,"Census Tract 9502, Kent County, Maryland",4783,797,685,391,410,112,963,879,566,509,84,1040,990,886,415,50,711,673,591,142,38,1272,1253,1224,131,19
1400000US24029950300,"Census Tract 9503, Kent County, Maryland",4265,1288,1223,614,943,65,1245,1093,805,599,152,442,442,422,168,0,488,415,324,221,73,802,752,712,118,50
1400000US24029950400,"Census Tract 9504, Kent County, Maryland",2881,248,217,95,180,31,531,467,272,276,64,700,676,625,185,24,397,397,360,135,0,1005,1005,894,312,0
1400000US24029950500,"Census Tract 9505, Kent County, Maryland",2581,370,271,131,238,99,696,641,390,378,55,439,377,355,155,62,366,311,276,71,55,710,651,626,123,59
1400000US24029990000,"Census Tract 9900, Kent County, Maryland",0,0,0,0,0,0,0,0,0,0,0,0,0,0,0,0,0,0,0,0,0,0,0,0,0,0
1400000US24031700101,"Census Tract 7001.01, Montgomery County, Maryland",4413,93,51,9,49,42,109,96,35,80,13,156,154,144,43,2,888,670,562,158,218,3167,3109,3088,426,58
1400000US24031700103,"Census Tract 7001.03, Montgomery County, Maryland",5773,310,267,69,239,43,225,225,225,34,0,179,161,152,64,18,388,388,388,1,0,4671,4596,4558,395,75
1400000US24031700104,"Census Tract 7001.04, Montgomery County, Maryland",4965,61,31,31,11,30,341,161,87,74,180,832,788,709,139,44,614,522,496,52,92,3117,2888,2793,388,229
1400000US24031700105,"Census Tract 7001.05, Montgomery County, Maryland",6603,81,81,55,36,0,988,658,560,113,330,950,751,597,165,199,760,634,634,0,126,3824,3784,3638,304,40
1400000US24031700204,"Census Tract 7002.04, Montgomery County, Maryland",2135,82,82,48,71,0,305,299,268,138,6,373,331,268,111,42,303,235,235,13,68,1072,1051,1035,108,21
1400000US24031700205,"Census Tract 7002.05, Montgomery County, Maryland",6559,133,133,45,97,0,236,177,166,83,59,380,353,333,43,27,564,561,536,84,3,5246,5159,5061,405,87
1400000US24031700206,"Census Tract 7002.06, Montgomery County, Maryland",5807,132,117,28,89,15,327,307,205,123,20,652,530,479,124,122,783,712,661,126,71,3913,3871,3791,228,42
1400000US24031700207,"Census Tract 7002.07, Montgomery County, Maryland",5871,870,747,151,602,123,905,775,524,327,130,862,778,678,126,84,878,783,769,143,95,2356,2333,2307,87,23
1400000US24031700208,"Census Tract 7002.08, Montgomery County, Maryland",1842,71,57,34,39,14,88,88,51,73,0,346,314,249,118,32,221,208,183,31,13,1116,1073,1035,135,43
1400000US24031700304,"Census Tract 7003.04, Montgomery County, Maryland",7729,578,400,33,367,178,673,348,258,210,325,833,671,552,184,162,931,724,697,48,207,4714,4589,4486,182,125
1400000US24031700306,"Census Tract 7003.06, Montgomery County, Maryland",6798,411,337,116,238,74,388,319,243,76,69,1019,836,757,110,183,864,774,681,182,90,4116,3608,3437,306,508
1400000US24031700308,"Census Tract 7003.08, Montgomery County, Maryland",5658,553,460,148,350,93,332,315,252,141,17,1112,1064,708,411,48,703,667,637,45,36,2958,2856,2840,102,102
1400000US24031700309,"Census Tract 7003.09, Montgomery County, Maryland",5431,801,538,151,405,263,844,615,421,232,229,808,745,684,187,63,1402,1179,1079,113,223,1576,1474,1443,80,102
1400000US24031700310,"Census Tract 7003.10, Montgomery County, Maryland",5594,290,230,184,173,60,1084,799,540,306,285,1067,891,849,79,176,928,893,848,88,35,2225,2099,2056,169,126
1400000US24031700311,"Census Tract 7003.11, Montgomery County, Maryland",6813,36,36,15,36,0,144,86,70,31,58,685,619,619,49,66,681,681,655,34,0,5267,4945,4892,162,322
1400000US24031700312,"Census Tract 7003.12, Montgomery County, Maryland",5107,135,126,69,96,9,339,284,284,39,55,573,450,352,189,123,520,500,500,37,20,3540,3272,3237,373,268
1400000US24031700400,"Census Tract 7004, Montgomery County, Maryland",2173,167,114,98,32,53,124,116,95,41,8,234,206,197,78,28,153,123,123,26,30,1495,1484,1401,307,11
1400000US24031700500,"Census Tract 7005, Montgomery County, Maryland",6117,76,50,36,38,26,802,601,583,149,201,1212,1116,1019,272,96,449,352,352,45,97,3578,3533,3520,181,45
1400000US24031700604,"Census Tract 7006.04, Montgomery County, Maryland",6697,139,124,56,82,15,355,280,246,121,75,209,179,179,16,30,463,463,448,137,0,5531,5397,5247,476,134
1400000US24031700606,"Census Tract 7006.06, Montgomery County, Maryland",4503,42,35,23,35,7,235,180,103,102,55,198,180,168,57,18,313,293,293,8,20,3715,3621,3574,279,94
1400000US24031700607,"Census Tract 7006.07, Montgomery County, Maryland",7904,202,171,114,86,31,472,434,342,120,38,464,444,430,14,20,496,446,429,17,50,6270,6158,6040,355,112
1400000US24031700608,"Census Tract 7006.08, Montgomery County, Maryland",5853,236,221,195,26,15,236,226,198,71,10,113,113,113,24,0,176,176,147,86,0,5092,4928,4745,475,164
1400000US24031700610,"Census Tract 7006.10, Montgomery County, Maryland",1987,60,45,23,33,15,88,88,48,72,0,214,148,131,38,66,155,119,119,30,36,1470,1443,1382,201,27
1400000US24031700611,"Census Tract 7006.11, Montgomery County, Maryland",6627,17,17,9,8,0,297,155,124,48,142,386,356,277,89,30,772,772,772,0,0,5155,4630,4541,443,525
1400000US24031700613,"Census Tract 7006.13, Montgomery County, Maryland",6138,267,202,190,28,65,554,499,376,123,55,625,573,520,102,52,753,682,401,344,71,3939,3831,3722,278,108
1400000US24031700614,"Census Tract 7006.14, Montgomery County, Maryland",4535,335,278,115,229,57,591,545,364,222,46,830,662,632,64,168,598,448,448,0,150,2181,2065,2020,123,116
1400000US24031700615,"Census Tract 7006.15, Montgomery County, Maryland",2974,23,23,23,5,0,34,34,10,24,0,131,131,131,0,0,102,102,102,4,0,2684,2616,2568,147,68
1400000US24031700616,"Census Tract 7006.16, Montgomery County, Maryland",4485,127,127,82,45,0,409,409,401,107,0,457,306,268,96,151,292,292,292,45,0,3200,3112,3048,256,88
1400000US24031700704,"Census Tract 7007.04, Montgomery County, Maryland",2945,219,142,55,100,77,823,459,295,182,364,260,153,101,60,107,360,335,312,61,25,1283,1120,1015,237,163
1400000US24031700706,"Census Tract 7007.06, Montgomery County, Maryland",3614,442,306,199,122,136,645,333,188,155,312,847,747,550,221,100,472,406,365,50,66,1208,1171,1019,290,37
1400000US24031700710,"Census Tract 7007.10, Montgomery County, Maryland",6522,467,314,48,314,153,1087,735,505,332,352,1177,639,324,360,538,631,585,575,94,46,3160,3020,2943,397,140
1400000US24031700711,"Census Tract 7007.11, Montgomery County, Maryland",5588,269,223,112,145,46,877,761,463,400,116,712,448,384,125,264,975,933,871,166,42,2755,2699,2623,368,56
1400000US24031700713,"Census Tract 7007.13, Montgomery County, Maryland",5559,731,390,117,273,341,2058,1334,633,747,724,1265,919,846,135,346,573,312,244,124,261,932,827,774,59,105
1400000US24031700715,"Census Tract 7007.15, Montgomery County, Maryland",6045,386,302,33,302,84,324,292,190,115,32,1306,1120,850,337,186,836,649,543,136,187,3193,2620,2279,465,573
1400000US24031700716,"Census Tract 7007.16, Montgomery County, Maryland",7435,559,490,122,416,69,1734,1538,1225,403,196,737,669,523,174,68,1148,960,847,164,188,3257,3099,3072,106,158
1400000US24031700717,"Census Tract 7007.17, Montgomery County, Maryland",5588,374,266,130,154,108,730,468,338,222,262,1928,1577,1108,475,351,828,503,468,35,325,1728,1633,1548,164,95
1400000US24031700718,"Census Tract 7007.18, Montgomery County, Maryland",4239,161,134,48,108,27,326,304,231,195,22,509,440,419,86,69,690,635,600,116,55,2553,2459,2372,379,94
1400000US24031700719,"Census Tract 7007.19, Montgomery County, Maryland",8300,1018,512,151,448,506,1172,957,802,169,215,1929,1030,887,154,899,528,435,387,86,93,3653,2807,2282,644,846
1400000US24031700720,"Census Tract 7007.20, Montgomery County, Maryland",3407,156,156,90,132,0,606,356,96,260,250,192,111,111,13,81,489,489,463,86,0,1964,1814,1749,132,150
1400000US24031700721,"Census Tract 7007.21, Montgomery County, Maryland",2446,405,229,115,183,176,653,468,300,256,185,476,420,408,12,56,236,228,188,40,8,676,631,631,38,45
1400000US24031700722,"Census Tract 7007.22, Montgomery County, Maryland",4217,468,270,110,160,198,564,432,329,185,132,697,604,476,205,93,737,570,570,17,167,1751,1599,1553,147,152
1400000US24031700723,"Census Tract 7007.23, Montgomery County, Maryland",2934,640,530,212,464,110,569,490,331,375,79,590,590,575,245,0,389,366,366,165,23,746,728,728,197,18
1400000US24031700724,"Census Tract 7007.24, Montgomery County, Maryland",3318,1102,566,363,277,536,1075,802,430,392,273,482,401,401,21,81,302,281,281,0,21,357,312,312,31,45
1400000US24031700810,"Census Tract 7008.10, Montgomery County, Maryland",5249,352,277,49,239,75,925,633,434,294,292,678,578,401,337,100,680,526,507,94,154,2614,2426,2366,246,188
1400000US24031700811,"Census Tract 7008.11, Montgomery County, Maryland",4813,229,141,118,53,88,540,530,378,196,10,911,713,584,176,198,973,816,804,55,157,2160,1920,1734,296,240
1400000US24031700812,"Census Tract 7008.12, Montgomery County, Maryland",4160,166,158,62,139,8,769,710,458,318,59,478,287,243,107,191,848,723,576,196,125,1899,1862,1795,324,37
1400000US24031700813,"Census Tract 7008.13, Montgomery County, Maryland",5963,277,207,132,155,70,1293,915,386,703,378,1027,827,748,161,200,519,380,332,98,139,2847,2498,2362,479,349
1400000US24031700815,"Census Tract 7008.15, Montgomery County, Maryland",8446,536,327,123,280,209,1389,1053,613,525,336,2084,1398,1062,353,686,893,860,842,39,33,3544,3005,2942,290,539
1400000US24031700816,"Census Tract 7008.16, Montgomery County, Maryland",7760,763,694,150,558,69,1019,703,532,239,316,1656,1528,1368,212,128,1427,1031,901,188,396,2895,2699,2627,165,196
1400000US24031700817,"Census Tract 7008.17, Montgomery County, Maryland",4760,414,273,209,133,141,686,664,476,214,22,755,701,701,67,54,624,607,596,116,17,2281,2146,2146,99,135
1400000US24031700818,"Census Tract 7008.18, Montgomery County, Maryland",6202,1302,1077,487,684,225,524,468,371,128,56,1502,1185,722,463,317,1558,1216,1148,136,342,1316,1200,1171,102,116
1400000US24031700819,"Census Tract 7008.19, Montgomery County, Maryland",7111,307,271,214,137,36,1128,858,425,433,270,1369,1219,1076,264,150,651,606,534,136,45,3656,2883,2811,135,773
1400000US24031700820,"Census Tract 7008.20, Montgomery County, Maryland",2986,372,178,41,143,194,306,158,98,68,148,873,695,483,257,178,480,384,161,263,96,955,955,955,44,0
1400000US24031700822,"Census Tract 7008.22, Montgomery County, Maryland",1669,347,256,17,251,91,398,257,96,173,141,328,282,273,47,46,220,172,172,14,48,376,276,276,20,100
1400000US24031700823,"Census Tract 7008.23, Montgomery County, Maryland",3400,113,63,43,38,50,353,299,299,190,54,448,415,334,165,33,448,383,287,111,65,2038,1934,1888,101,104
1400000US24031700824,"Census Tract 7008.24, Montgomery County, Maryland",3023,55,46,33,13,9,198,196,145,72,2,523,421,262,228,102,94,94,94,44,0,2153,2104,2090,123,49
1400000US24031700826,"Census Tract 7008.26, Montgomery County, Maryland",5952,131,131,131,72,0,395,395,372,151,0,545,506,506,116,39,375,351,306,205,24,4506,4281,4265,188,225
1400000US24031700828,"Census Tract 7008.28, Montgomery County, Maryland",2456,62,62,29,33,0,98,98,98,0,0,71,9,4,5,62,134,134,119,21,0,2091,2071,2041,86,20
1400000US24031700829,"Census Tract 7008.29, Montgomery County, Maryland",2939,174,160,106,102,14,178,122,109,23,56,207,207,182,59,0,213,213,213,74,0,2167,2112,2084,111,55
1400000US24031700830,"Census Tract 7008.30, Montgomery County, Maryland",2540,40,40,0,40,0,650,478,399,91,172,836,534,299,259,302,245,245,245,0,0,769,697,697,31,72
1400000US24031700832,"Census Tract 7008.32, Montgomery County, Maryland",2708,292,204,49,181,88,442,385,271,128,57,744,655,538,151,89,653,631,462,191,22,577,571,558,108,6
1400000US24031700833,"Census Tract 7008.33, Montgomery County, Maryland",4591,707,454,18,436,253,521,401,162,257,120,1077,808,565,312,269,544,463,399,85,81,1742,1695,1671,62,47
1400000US24031700834,"Census Tract 7008.34, Montgomery County, Maryland",5058,159,69,44,33,90,856,610,410,288,246,1279,1050,869,181,229,780,707,558,149,73,1984,1929,1869,114,55
1400000US24031700835,"Census Tract 7008.35, Montgomery County, Maryland",4581,115,115,115,14,0,49,49,49,0,0,642,483,421,73,159,438,374,374,19,64,3337,3218,3151,352,119
1400000US24031700901,"Census Tract 7009.01, Montgomery County, Maryland",3536,759,684,319,583,75,472,370,346,123,102,277,267,248,63,10,463,423,423,0,40,1565,1533,1533,127,32
1400000US24031700902,"Census Tract 7009.02, Montgomery County, Maryland",3523,322,154,69,118,168,445,268,149,160,177,645,480,441,112,165,719,475,435,94,244,1392,1191,1051,198,201
1400000US24003740201,"Census Tract 7402.01, Anne Arundel County, Maryland",6743,876,647,444,354,229,867,811,705,342,56,1560,1514,1324,308,46,1009,773,715,137,236,2431,2243,2076,362,188
1400000US24003740203,"Census Tract 7402.03, Anne Arundel County, Maryland",5289,112,103,25,103,9,455,354,167,292,101,464,451,424,120,13,692,589,560,178,103,3566,3390,3232,328,176
1400000US24003740303,"Census Tract 7403.03, Anne Arundel County, Maryland",4138,253,212,144,92,41,583,464,365,273,119,663,570,526,271,93,687,627,566,123,60,1952,1836,1791,297,116
1400000US24003740304,"Census Tract 7403.04, Anne Arundel County, Maryland",3622,300,250,210,93,50,416,405,367,92,11,581,535,535,46,46,385,385,330,68,0,1940,1912,1886,119,28
1400000US24003740305,"Census Tract 7403.05, Anne Arundel County, Maryland",10378,577,502,149,353,75,657,607,357,404,50,1845,1675,1164,511,170,2185,2168,2082,286,17,5114,4885,4770,405,229
1400000US24003740400,"Census Tract 7404, Anne Arundel County, Maryland",0,0,0,0,0,0,0,0,0,0,0,0,0,0,0,0,0,0,0,0,0,0,0,0,0,0
1400000US24003740500,"Census Tract 7405, Anne Arundel County, Maryland",8603,249,249,100,149,0,943,731,620,173,212,1136,934,719,227,202,1222,1199,1178,119,23,5053,4797,4721,201,256
1400000US24003740601,"Census Tract 7406.01, Anne Arundel County, Maryland",4223,290,290,290,0,0,1082,1070,1070,103,12,964,964,964,0,0,1020,1020,1020,0,0,867,853,853,75,14
1400000US24003740602,"Census Tract 7406.02, Anne Arundel County, Maryland",3041,117,117,117,0,0,959,959,959,191,0,847,789,720,82,58,477,477,477,10,0,641,641,633,36,0
1400000US24003740603,"Census Tract 7406.03, Anne Arundel County, Maryland",613,33,33,1,33,0,100,100,100,0,0,100,100,100,0,0,104,78,78,0,26,276,270,270,2,6
1400000US24003740701,"Census Tract 7407.01, Anne Arundel County, Maryland",5221,542,542,417,191,0,828,625,458,302,203,546,546,533,107,0,1074,1008,896,217,66,2231,2195,2138,330,36
1400000US24003740702,"Census Tract 7407.02, Anne Arundel County, Maryland",9269,425,368,280,236,57,966,817,764,595,149,747,726,629,281,21,1149,1149,1149,107,0,5982,5733,5664,338,249
1400000US24003740800,"Census Tract 7408, Anne Arundel County, Maryland",4014,101,101,91,38,0,384,319,276,194,65,634,634,517,187,0,489,480,461,174,9,2406,2319,2283,324,87
1400000US24003740900,"Census Tract 7409, Anne Arundel County, Maryland",7231,313,313,168,192,0,1399,1172,966,283,227,926,869,830,161,57,977,947,884,179,30,3616,3470,3407,380,146
1400000US24003741000,"Census Tract 7410, Anne Arundel County, Maryland",2256,35,26,16,26,9,170,170,154,104,0,147,122,117,31,25,367,367,360,68,0,1537,1487,1467,106,50
1400000US24003750101,"Census Tract 7501.01, Anne Arundel County, Maryland",4659,781,683,186,606,98,1207,1138,569,821,69,825,770,664,262,55,796,705,649,129,91,1050,918,898,204,132
1400000US24003750102,"Census Tract 7501.02, Anne Arundel County, Maryland",2390,166,110,62,60,56,542,482,321,256,60,1016,943,838,307,73,282,278,278,9,4,384,325,256,89,59
1400000US24003750201,"Census Tract 7502.01, Anne Arundel County, Maryland",2765,528,432,181,349,96,496,349,234,225,147,564,460,426,157,104,375,338,248,123,37,802,638,626,89,164
1400000US24003750202,"Census Tract 7502.02, Anne Arundel County, Maryland",3234,314,314,236,263,0,657,526,391,311,131,313,285,266,84,28,438,341,284,99,97,1512,1432,1402,162,80
1400000US24003750203,"Census Tract 7502.03, Anne Arundel County, Maryland",1503,211,156,37,131,55,251,235,99,199,16,343,246,206,77,97,433,352,289,98,81,265,249,242,33,16
1400000US24003750300,"Census Tract 7503, Anne Arundel County, Maryland",2795,123,123,92,99,0,752,694,532,345,58,823,728,458,338,95,596,589,533,89,7,501,501,489,52,0
1400000US24003750400,"Census Tract 7504, Anne Arundel County, Maryland",4150,240,240,182,190,0,482,457,347,258,25,666,541,495,258,125,476,434,434,92,42,2286,2252,2195,267,34
1400000US24003750801,"Census Tract 7508.01, Anne Arundel County, Maryland",5724,194,194,161,160,0,968,721,632,285,247,924,880,741,226,44,984,984,923,133,0,2654,2608,2395,329,46
1400000US24003750803,"Census Tract 7508.03, Anne Arundel County, Maryland",7299,785,686,214,536,99,1227,1044,842,450,183,2181,1566,1079,609,615,1516,1324,1324,0,192,1590,1338,1005,404,252
1400000US24003750804,"Census Tract 7508.04, Anne Arundel County, Maryland",4350,376,324,142,260,52,645,549,413,318,96,869,675,500,309,194,1156,838,738,207,318,1304,1070,1054,159,234
1400000US24003750900,"Census Tract 7509, Anne Arundel County, Maryland",2863,520,452,174,395,68,378,304,217,173,74,507,493,400,160,14,422,330,307,58,92,1036,971,852,258,65
1400000US24003751000,"Census Tract 7510, Anne Arundel County, Maryland",3768,297,259,113,259,38,848,745,654,207,103,1170,1054,992,225,116,536,451,411,167,85,917,868,704,222,49
1400000US24003751102,"Census Tract 7511.02, Anne Arundel County, Maryland",3666,320,287,216,196,33,691,676,530,303,15,537,522,433,169,15,949,875,824,156,74,1169,1065,941,200,104
1400000US24003751103,"Census Tract 7511.03, Anne Arundel County, Maryland",5544,622,439,272,324,183,802,529,393,352,273,1118,1077,804,447,41,980,965,955,104,15,2022,1868,1771,253,154
1400000US24003751200,"Census Tract 7512, Anne Arundel County, Maryland",4132,463,451,354,289,12,667,555,427,388,112,508,474,439,150,34,262,262,262,62,0,2232,2032,1979,204,200
1400000US24003751400,"Census Tract 7514, Anne Arundel County, Maryland",4031,213,182,90,123,31,205,155,107,113,50,444,374,343,198,70,599,543,522,204,56,2570,2473,2442,181,97
1400000US24003751500,"Census Tract 7515, Anne Arundel County, Maryland",6150,468,238,166,132,230,954,864,703,417,90,1405,1253,968,458,152,1138,1093,1027,258,45,2185,2085,1995,327,100
1400000US24003751600,"Census Tract 7516, Anne Arundel County, Maryland",4698,455,421,379,329,34,711,711,593,553,0,670,581,441,500,89,854,854,808,366,0,2008,2008,1945,698,0
1400000US24003751700,"Census Tract 7517, Anne Arundel County, Maryland",2664,17,12,12,12,5,156,98,98,64,58,85,85,85,53,0,390,361,342,24,29,2016,1954,1864,249,62
1400000US24003980000,"Census Tract 9800, Anne Arundel County, Maryland",0,0,0,0,0,0,0,0,0,0,0,0,0,0,0,0,0,0,0,0,0,0,0,0,0,0
1400000US24003990000,"Census Tract 9900, Anne Arundel County, Maryland",0,0,0,0,0,0,0,0,0,0,0,0,0,0,0,0,0,0,0,0,0,0,0,0,0,0
1400000US24005400100,"Census Tract 4001, Baltimore County, Maryland",4399,884,862,603,759,22,490,490,408,434,0,1165,1134,836,731,31,554,554,510,415,0,1306,1276,1203,350,30
1400000US24005400200,"Census Tract 4002, Baltimore County, Maryland",2536,153,153,87,126,0,482,436,384,76,46,589,519,469,81,70,375,369,357,35,6,937,810,721,89,127
1400000US24005400400,"Census Tract 4004, Baltimore County, Maryland",5243,356,239,169,162,117,385,322,322,148,63,652,558,520,144,94,731,714,714,100,17,3119,3023,2868,336,96
1400000US24005400500,"Census Tract 4005, Baltimore County, Maryland",2380,81,71,17,71,10,113,113,113,63,0,235,235,235,63,0,245,233,216,45,12,1706,1695,1688,98,11
1400000US24005400600,"Census Tract 4006, Baltimore County, Maryland",2835,517,440,247,346,77,346,313,190,173,33,547,518,488,124,29,389,389,389,42,0,1036,1036,1009,45,0
1400000US24005400701,"Census Tract 4007.01, Baltimore County, Maryland",2815,145,133,111,70,12,738,582,570,106,156,671,548,482,108,123,379,379,363,16,0,882,813,804,48,69
1400000US24005400702,"Census Tract 4007.02, Baltimore County, Maryland",1598,97,92,36,68,5,207,194,132,115,13,183,168,158,52,15,390,373,328,67,17,721,721,707,62,0
1400000US24005400800,"Census Tract 4008, Baltimore County, Maryland",2783,341,277,102,260,64,349,232,179,99,117,766,766,720,238,0,520,520,509,11,0,807,764,674,218,43
1400000US24005400900,"Census Tract 4009, Baltimore County, Maryland",2139,459,365,119,355,94,498,300,213,139,198,213,213,204,49,0,209,205,205,15,4,760,742,722,86,18
1400000US24005401000,"Census Tract 4010, Baltimore County, Maryland",2403,170,160,46,156,10,553,473,464,69,80,284,269,250,116,15,593,548,319,272,45,803,796,790,15,7
1400000US24005401101,"Census Tract 4011.01, Baltimore County, Maryland",6673,455,367,108,327,88,2152,1831,1511,469,321,1801,1593,1370,315,208,1030,956,777,266,74,1235,1188,1151,177,47
1400000US24005401102,"Census Tract 4011.02, Baltimore County, Maryland",1147,278,208,116,124,70,381,368,360,151,13,132,114,94,50,18,144,132,132,11,12,212,159,149,27,53
1400000US24005401200,"Census Tract 4012, Baltimore County, Maryland",3567,260,196,69,190,64,697,542,270,374,155,1118,944,702,302,174,635,545,480,151,90,857,786,736,96,71
1400000US24005401301,"Census Tract 4013.01, Baltimore County, Maryland",3577,380,347,114,303,33,544,500,414,166,44,1111,1066,946,225,45,657,636,559,233,21,885,824,789,84,61
1400000US24005401302,"Census Tract 4013.02, Baltimore County, Maryland",2430,514,471,348,314,43,620,534,384,256,86,615,524,524,17,91,380,374,360,24,6,301,295,295,9,6
1400000US24005401400,"Census Tract 4014, Baltimore County, Maryland",1774,47,47,44,38,0,152,152,152,107,0,168,160,58,117,8,319,319,319,94,0,1088,1074,1055,83,14
1400000US24005401503,"Census Tract 4015.03, Baltimore County, Maryland",6524,374,349,298,218,25,640,621,513,334,19,1641,1574,1462,330,67,977,977,964,138,0,2892,2861,2817,282,31
1400000US24005401504,"Census Tract 4015.04, Baltimore County, Maryland",6103,424,364,144,261,60,643,549,519,94,94,1598,1291,895,487,307,762,713,660,297,49,2676,2458,2299,395,218
1400000US24005401505,"Census Tract 4015.05, Baltimore County, Maryland",3922,364,323,109,323,41,405,352,260,262,53,852,786,680,227,66,946,903,800,130,43,1355,1259,1212,159,96
1400000US24005401506,"Census Tract 4015.06, Baltimore County, Maryland",5273,394,346,105,252,48,1080,954,839,146,126,1069,981,628,384,88,1253,1225,1213,12,28,1477,1369,1325,64,108
1400000US24005401507,"Census Tract 4015.07, Baltimore County, Maryland",5347,1088,841,208,706,247,915,814,664,229,101,1274,1106,1017,136,168,1281,1088,1068,34,193,789,727,727,26,62
1400000US24005402201,"Census Tract 4022.01, Baltimore County, Maryland",2990,145,145,86,145,0,89,89,76,28,0,441,416,409,114,25,328,262,243,97,66,1987,1711,1637,247,276
1400000US24005402202,"Census Tract 4022.02, Baltimore County, Maryland",1551,92,92,88,26,0,124,116,116,31,8,281,228,218,84,53,37,37,37,12,0,1017,1010,1003,78,7
1400000US24005402302,"Census Tract 4023.02, Baltimore County, Maryland",4931,312,186,152,66,126,892,805,622,376,87,1046,958,887,146,88,1041,935,818,239,106,1640,1535,1378,351,105
1400000US24005402303,"Census Tract 4023.03, Baltimore County, Maryland",6695,511,392,275,209,119,1526,1420,905,700,106,1141,929,817,464,212,1152,869,762,381,283,2365,2178,2128,220,187
1400000US24005402304,"Census Tract 4023.04, Baltimore County, Maryland",3686,601,418,370,202,183,660,627,464,390,33,1107,853,621,385,254,347,320,284,123,27,971,836,836,63,135
1400000US24005402305,"Census Tract 4023.05, Baltimore County, Maryland",2207,370,314,173,171,56,800,642,544,242,158,461,429,354,174,32,149,149,142,68,0,427,415,397,125,12
1400000US24005402306,"Census Tract 4023.06, Baltimore County, Maryland",3814,450,407,239,336,43,963,677,375,410,286,709,581,550,80,128,851,831,738,185,20,841,806,737,132,35
1400000US24005402307,"Census Tract 4023.07, Baltimore County, Maryland",5783,608,424,123,320,184,1300,1097,898,356,203,1787,1414,1085,372,373,1266,1097,1055,142,169,822,795,777,174,27
1400000US24005402403,"Census Tract 4024.03, Baltimore County, Maryland",2535,762,571,109,524,191,520,506,453,212,14,327,318,306,102,9,575,539,502,170,36,351,335,295,117,16
1400000US24005402404,"Census Tract 4024.04, Baltimore County, Maryland",5286,1353,948,475,604,405,1422,1168,674,607,254,743,695,587,233,48,554,536,527,95,18,1214,1179,1060,236,35
1400000US24005402405,"Census Tract 4024.05, Baltimore County, Maryland",2977,326,318,246,129,8,859,803,661,357,56,763,571,450,219,192,166,166,132,66,0,863,830,736,178,33
1400000US24005402406,"Census Tract 4024.06, Baltimore County, Maryland",6544,1188,1125,322,888,63,1602,1310,1048,316,292,2015,1745,1256,666,270,1221,993,832,208,228,518,476,455,57,42
1400000US24005402407,"Census Tract 4024.07, Baltimore County, Maryland",1611,67,67,39,44,0,168,127,77,97,41,452,425,380,83,27,347,334,334,12,13,577,325,252,110,252
1400000US24005402503,"Census Tract 4025.03, Baltimore County, Maryland",4355,1095,1000,195,879,95,908,865,660,357,43,884,693,505,263,191,545,463,362,183,82,923,882,798,126,41
1400000US24005402504,"Census Tract 4025.04, Baltimore County, Maryland",4555,144,115,55,70,29,508,508,436,165,0,430,398,383,70,32,1003,1003,899,188,0,2470,2378,2264,322,92
1400000US24005402505,"Census Tract 4025.05, Baltimore County, Maryland",2914,286,193,66,166,93,1119,1020,638,551,99,285,268,215,62,17,575,575,518,68,0,649,649,636,128,0
1400000US24005402506,"Census Tract 4025.06, Baltimore County, Maryland",4125,285,263,144,184,22,721,665,507,250,56,932,842,515,421,90,589,500,484,71,89,1598,1463,1365,310,135
1400000US24005402509,"Census Tract 4025.09, Baltimore County, Maryland",8761,418,378,335,179,40,1101,777,680,358,324,1178,1129,1129,116,49,1462,1377,1319,116,85,4602,4381,4239,201,221
1400000US24005402602,"Census Tract 4026.02, Baltimore County, Maryland",1969,88,85,59,60,3,242,189,186,60,53,439,406,370,113,33,584,495,459,79,89,616,575,558,73,41
1400000US24005402603,"Census Tract 4026.03, Baltimore County, Maryland",6585,117,117,82,73,0,346,339,285,231,7,938,875,769,239,63,1620,1586,1484,162,34,3564,3262,2986,586,302
1400000US24005402604,"Census Tract 4026.04, Baltimore County, Maryland",5671,332,313,224,215,19,408,367,353,97,41,1098,1098,937,473,0,740,678,612,198,62,3093,2888,2679,318,205
1400000US24005403100,"Census Tract 4031, Baltimore County, Maryland",2319,218,210,95,195,8,521,517,366,411,4,605,425,332,173,180,249,244,138,140,5,726,673,655,79,53
1400000US24005403201,"Census Tract 4032.01, Baltimore County, Maryland",2688,271,271,160,230,0,497,453,368,277,44,691,526,484,124,165,535,465,389,111,70,694,674,638,114,20
1400000US24005403202,"Census Tract 4032.02, Baltimore County, Maryland",2103,150,150,62,98,0,517,488,416,162,29,451,381,296,219,70,349,329,329,59,20,636,526,482,84,110
1400000US24005403300,"Census Tract 4033, Baltimore County, Maryland",2195,96,96,68,88,0,363,308,237,143,55,463,437,419,88,26,498,498,486,68,0,775,713,586,146,62
1400000US24005403401,"Census Tract 4034.01, Baltimore County, Maryland",3169,499,499,319,478,0,572,452,364,354,120,512,486,462,110,26,722,702,652,161,20,864,820,795,234,44
1400000US24005403402,"Census Tract 4034.02, Baltimore County, Maryland",4446,1234,1017,274,955,217,1237,1076,714,502,161,763,483,359,197,280,435,348,226,163,87,777,551,551,100,226
1400000US24005403500,"Census Tract 4035, Baltimore County, Maryland",5018,387,337,211,238,50,666,623,503,261,43,920,858,804,219,62,676,676,652,160,0,2369,2346,2241,364,23
1400000US24005403601,"Census Tract 4036.01, Baltimore County, Maryland",4809,378,370,262,156,8,842,692,659,345,150,560,531,531,85,29,557,535,458,173,22,2472,2354,2311,206,118
1400000US24005403602,"Census Tract 4036.02, Baltimore County, Maryland",5447,375,342,315,241,33,610,466,409,206,144,1127,939,859,155,188,779,779,779,70,0,2556,2514,2433,211,42
1400000US24005403701,"Census Tract 4037.01, Baltimore County, Maryland",6508,568,533,278,432,35,811,760,586,302,51,973,877,821,350,96,1267,1187,1141,332,80,2889,2889,2694,635,0
1400000US24005403702,"Census Tract 4037.02, Baltimore County, Maryland",3997,256,256,122,239,0,656,585,492,206,71,475,475,475,105,0,723,697,639,118,26,1887,1770,1681,387,117
1400000US24005403801,"Census Tract 4038.01, Baltimore County, Maryland",1711,98,98,91,55,0,114,94,65,29,20,179,173,173,6,6,131,131,131,38,0,1189,1175,1161,192,14
1400000US24005403802,"Census Tract 4038.02, Baltimore County, Maryland",2845,94,82,41,49,12,109,99,89,54,10,76,76,40,67,0,255,255,244,94,0,2311,2281,2212,538,30
1400000US24005403803,"Census Tract 4038.03, Baltimore County, Maryland",3285,142,142,130,119,0,431,422,382,225,9,237,204,204,82,33,278,266,247,175,12,2197,2182,2103,554,15
1400000US24005404101,"Census Tract 4041.01, Baltimore County, Maryland",4701,33,18,0,18,15,569,491,303,288,78,528,528,469,200,0,607,591,580,45,16,2964,2886,2798,310,78
1400000US24005404102,"Census Tract 4041.02, Baltimore County, Maryland",5821,678,555,205,456,123,711,666,596,270,45,1469,1341,1028,485,128,965,797,753,88,168,1998,1953,1944,47,45
1400000US24005404201,"Census Tract 4042.01, Baltimore County, Maryland",6287,808,632,345,339,176,1306,880,741,270,426,965,790,638,201,175,753,472,389,133,281,2455,2345,2310,118,110
1400000US24005404202,"Census Tract 4042.02, Baltimore County, Maryland",7118,699,543,390,248,156,1162,907,651,378,255,2363,1752,1418,569,611,1194,1160,1118,232,34,1700,1659,1589,97,41
1400000US24005404402,"Census Tract 4044.02, Baltimore County, Maryland",6374,147,147,74,125,0,403,392,289,151,11,915,852,777,161,63,873,826,826,164,47,4036,3931,3861,228,105
1400000US24005404403,"Census Tract 4044.03, Baltimore County, Maryland",5008,842,605,288,364,237,1063,888,598,438,175,1079,1020,690,438,59,580,431,415,32,149,1444,1411,1365,95,33
1400000US24005404404,"Census Tract 4044.04, Baltimore County, Maryland",4836,678,550,305,394,128,884,531,501,138,353,755,732,622,217,23,617,594,594,26,23,1902,1592,1567,132,310
1400000US24005404501,"Census Tract 4045.01, Baltimore County, Maryland",7189,1194,710,303,515,484,1281,1091,690,550,190,1724,1411,952,796,313,1145,1145,1112,212,0,1845,1804,1804,174,41
1400000US24005404502,"Census Tract 4045.02, Baltimore County, Maryland",3760,682,616,237,441,66,975,827,518,427,148,1027,961,885,202,66,597,597,503,122,0,479,463,439,77,16
1400000US24005404600,"Census Tract 4046, Baltimore County, Maryland",2383,171,150,129,110,21,412,284,223,176,128,277,268,268,61,9,219,204,180,40,15,1304,1246,1221,75,58
1400000US24005404800,"Census Tract 4048, Baltimore County, Maryland",1956,169,169,111,129,0,178,165,165,22,13,117,117,111,66,0,390,360,331,84,30,1102,1045,1020,165,57
1400000US24005404900,"Census Tract 4049, Baltimore County, Maryland",4941,584,584,154,572,0,259,251,226,151,8,244,205,186,36,39,464,449,449,43,15,3390,3370,3326,197,20
1400000US24005405000,"Census Tract 4050, Baltimore County, Maryland",4362,358,304,279,106,54,588,552,470,299,36,444,378,378,128,66,666,651,645,83,15,2306,2193,2158,181,113
1400000US24005406000,"Census Tract 4060, Baltimore County, Maryland",5542,206,199,138,92,7,467,467,416,243,0,615,589,548,148,26,690,643,643,179,47,3564,3509,3472,231,55
1400000US24005407001,"Census Tract 4070.01, Baltimore County, Maryland",3288,173,173,161,60,0,412,388,303,172,24,637,620,561,140,17,354,307,293,111,47,1712,1703,1658,143,9
1400000US24005407002,"Census Tract 4070.02, Baltimore County, Maryland",6014,190,105,80,47,85,608,608,588,184,0,1232,1137,1029,332,95,641,624,607,101,17,3343,3266,3214,259,77
1400000US24005408100,"Census Tract 4081, Baltimore County, Maryland",6168,352,336,291,180,16,550,481,481,228,69,870,828,777,298,42,511,511,511,37,0,3885,3861,3830,238,24
1400000US24005408200,"Census Tract 4082, Baltimore County, Maryland",2006,91,91,80,43,0,337,301,292,33,36,332,283,229,144,49,49,49,40,22,0,1197,1184,1148,320,13
1400000US24005408302,"Census Tract 4083.02, Baltimore County, Maryland",2957,103,103,103,103,0,312,296,232,208,16,388,388,375,208,0,180,180,180,31,0,1974,1960,1915,344,14
1400000US24005408303,"Census Tract 4083.03, Baltimore County, Maryland",3675,72,72,42,30,0,51,51,37,37,0,264,264,248,63,0,375,375,375,76,0,2913,2913,2867,180,0
1400000US24005408304,"Census Tract 4083.04, Baltimore County, Maryland",4660,437,437,276,376,0,379,379,314,294,0,714,686,668,305,28,740,726,726,295,14,2390,2334,2283,358,56
1400000US24005408400,"Census Tract 4084, Baltimore County, Maryland",602,73,71,52,46,2,74,42,42,26,32,49,49,38,11,0,141,141,141,6,0,265,265,253,44,0
1400000US24005408502,"Census Tract 4085.02, Baltimore County, Maryland",5341,376,333,232,314,43,456,456,349,456,0,414,398,363,206,16,640,521,493,207,119,3455,3335,3190,565,120
1400000US24005408503,"Census Tract 4085.03, Baltimore County, Maryland",3275,453,373,75,334,80,758,493,357,195,265,558,519,453,111,39,554,533,515,73,21,952,890,873,91,62
1400000US24005408505,"Census Tract 4085.05, Baltimore County, Maryland",3866,283,273,178,162,10,366,362,308,128,4,403,371,312,122,32,769,727,707,181,42,2045,2021,1924,294,24
1400000US24005408506,"Census Tract 4085.06, Baltimore County, Maryland",4424,899,698,451,316,201,1167,800,618,227,367,560,543,456,134,17,1042,1032,1005,27,10,756,629,582,92,127
1400000US24005408507,"Census Tract 4085.07, Baltimore County, Maryland",5481,943,678,439,319,265,1452,1115,910,354,337,1294,1150,994,239,144,745,699,662,110,46,1047,1031,1031,0,16
1400000US24005408601,"Census Tract 4086.01, Baltimore County, Maryland",3799,151,128,100,91,23,544,472,388,331,72,507,494,474,245,13,539,493,466,114,46,2058,1905,1825,292,153
1400000US24005408602,"Census Tract 4086.02, Baltimore County, Maryland",2098,173,173,150,47,0,256,240,200,151,16,229,229,205,107,0,373,329,317,57,44,1067,1052,1043,124,15
1400000US24005408702,"Census Tract 4087.02, Baltimore County, Maryland",2417,29,29,19,22,0,193,193,183,125,0,242,230,202,107,12,452,452,444,122,0,1501,1501,1457,299,0
1400000US24005408703,"Census Tract 4087.03, Baltimore County, Maryland",5857,222,194,163,116,28,788,730,601,418,58,935,935,893,354,0,1188,1122,1082,93,66,2724,2696,2630,202,28
1400000US24005408704,"Census Tract 4087.04, Baltimore County, Maryland",5695,168,157,112,132,11,290,280,234,198,10,494,485,447,142,9,609,609,609,127,0,4134,4101,3922,411,33
1400000US24005408800,"Census Tract 4088, Baltimore County, Maryland",2285,212,195,138,119,17,385,342,190,197,43,381,381,343,125,0,245,245,215,39,0,1062,1053,1043,101,9
1400000US24005408900,"Census Tract 4089, Baltimore County, Maryland",2644,228,185,140,158,43,318,295,220,192,23,478,469,422,137,9,312,312,312,15,0,1308,1305,1260,187,3
1400000US24005410100,"Census Tract 4101, Baltimore County, Maryland",5824,216,171,98,129,45,329,329,267,173,0,342,342,325,58,0,319,319,290,136,0,4618,4448,4295,450,170
1400000US24005410200,"Census Tract 4102, Baltimore County, Maryland",4751,190,179,162,43,11,521,505,174,444,16,356,313,279,201,43,623,550,519,118,73,3061,3006,3000,223,55
1400000US24005411101,"Census Tract 4111.01, Baltimore County, Maryland",2283,162,162,111,89,0,150,125,95,70,25,396,273,259,70,123,390,390,363,80,0,1185,1125,1096,207,60
1400000US24005411102,"Census Tract 4111.02, Baltimore County, Maryland",2844,134,77,52,62,57,257,237,156,193,20,438,438,412,153,0,350,292,281,46,58,1665,1647,1647,132,18
1400000US24005411201,"Census Tract 4112.01, Baltimore County, Maryland",3271,132,119,64,86,13,300,263,202,146,37,450,450,418,212,0,312,280,259,74,32,2077,2054,1985,286,23
1400000US24005411202,"Census Tract 4112.02, Baltimore County, Maryland",3644,263,249,149,249,14,529,510,288,373,19,376,317,317,102,59,329,304,304,30,25,2147,2147,2131,283,0
1400000US24005411302,"Census Tract 4113.02, Baltimore County, Maryland",3385,343,308,239,90,35,269,229,212,130,40,582,393,307,116,189,267,240,240,46,27,1924,1850,1794,159,74
1400000US24005411303,"Census Tract 4113.03, Baltimore County, Maryland",5913,566,522,319,497,44,626,555,521,229,71,862,828,727,401,34,1163,1069,1056,155,94,2696,2636,2453,299,60
1400000US24005411306,"Census Tract 4113.06, Baltimore County, Maryland",5118,170,170,151,118,0,746,651,527,205,95,1209,1015,975,111,194,1250,1161,1105,179,89,1743,1659,1571,171,84
1400000US24005411307,"Census Tract 4113.07, Baltimore County, Maryland",3658,91,75,75,22,16,615,550,506,148,65,803,682,614,104,121,771,771,761,26,0,1378,1334,1311,34,44
1400000US24005411308,"Census Tract 4113.08, Baltimore County, Maryland",3303,155,127,51,98,28,282,282,272,78,0,474,456,416,232,18,964,942,942,73,22,1428,1404,1282,247,24
1400000US24005411309,"Census Tract 4113.09, Baltimore County, Maryland",8632,341,319,271,247,22,847,753,664,342,94,1269,1269,1260,444,0,1068,1034,881,275,34,5107,4878,4675,441,229
1400000US24005411404,"Census Tract 4114.04, Baltimore County, Maryland",3950,60,44,34,33,16,546,502,428,256,44,535,514,461,141,21,957,805,664,215,152,1852,1829,1785,171,23
1400000US24005411406,"Census Tract 4114.06, Baltimore County, Maryland",4332,256,256,236,186,0,684,562,435,277,122,440,422,422,145,18,682,665,665,103,17,2270,2257,2138,295,13
1400000US24005411407,"Census Tract 4114.07, Baltimore County, Maryland",9040,869,847,504,722,22,2680,2405,1602,1646,275,1791,1475,1475,554,316,1340,1251,1220,233,89,2360,2343,2275,259,17
1400000US24005411408,"Census Tract 4114.08, Baltimore County, Maryland",3187,284,257,189,115,27,825,653,470,272,172,721,715,700,58,6,549,549,549,32,0,808,800,763,69,8
1400000US24005411409,"Census Tract 4114.09, Baltimore County, Maryland",5180,163,125,117,42,38,577,486,376,194,91,898,872,829,142,26,950,939,899,74,11,2592,2543,2543,160,49
1400000US24005411410,"Census Tract 4114.10, Baltimore County, Maryland",4630,192,153,107,119,39,734,646,495,268,88,916,816,703,159,100,863,788,712,147,75,1925,1872,1849,152,53
1400000US24005420100,"Census Tract 4201, Baltimore County, Maryland",3397,456,379,327,197,77,993,863,596,530,130,583,505,414,251,78,732,647,535,204,85,633,581,547,109,52
1400000US24005420200,"Census Tract 4202, Baltimore County, Maryland",2403,521,497,191,468,24,679,632,551,362,47,381,353,295,136,28,373,357,357,26,16,449,423,379,81,26
1400000US24005420301,"Census Tract 4203.01, Baltimore County, Maryland",2743,625,611,332,346,14,760,704,522,376,56,676,618,546,147,58,367,351,282,84,16,315,262,191,71,53
1400000US24005420302,"Census Tract 4203.02, Baltimore County, Maryland",2792,218,198,38,195,20,476,460,211,365,16,1114,982,901,116,132,533,509,406,164,24,451,390,352,41,61
1400000US24005420303,"Census Tract 4203.03, Baltimore County, Maryland",1335,138,119,64,112,19,146,126,104,84,20,264,247,236,77,17,384,373,322,153,11,403,371,352,48,32
1400000US24005420401,"Census Tract 4204.01, Baltimore County, Maryland",6538,610,453,271,331,157,1526,1380,931,657,146,1882,1714,1492,440,168,1294,1206,983,361,88,1226,1062,674,489,164
1400000US24005420402,"Census Tract 4204.02, Baltimore County, Maryland",2114,241,229,117,134,12,524,488,345,188,36,477,412,358,82,65,470,455,392,107,15,402,393,318,115,9
1400000US24005420500,"Census Tract 4205, Baltimore County, Maryland",3253,543,428,280,337,115,509,472,354,301,37,852,692,629,186,160,763,583,511,142,180,586,575,541,58,11
1400000US24005420600,"Census Tract 4206, Baltimore County, Maryland",3931,898,754,171,687,144,1034,931,545,592,103,861,575,497,194,286,487,468,383,138,19,651,544,411,234,107
1400000US24005420701,"Census Tract 4207.01, Baltimore County, Maryland",3174,584,495,291,258,89,1481,1026,600,537,455,378,360,317,150,18,219,198,198,35,21,512,475,423,70,37
1400000US24005420702,"Census Tract 4207.02, Baltimore County, Maryland",1987,279,274,153,198,5,439,320,229,192,119,423,379,276,177,44,390,372,372,46,18,456,435,422,13,21
1400000US24005420800,"Census Tract 4208, Baltimore County, Maryland",3356,446,421,283,328,25,678,581,494,374,97,835,740,571,290,95,394,344,317,27,50,1003,931,909,107,72
1400000US24005420900,"Census Tract 4209, Baltimore County, Maryland",3309,746,543,287,446,203,599,532,391,213,67,788,738,689,150,50,674,472,403,69,202,502,464,397,129,38
1400000US24005421000,"Census Tract 4210, Baltimore County, Maryland",1887,817,637,231,519,180,473,415,220,299,58,185,178,178,25,7,259,257,250,75,2,153,153,148,15,0
1400000US24005421101,"Census Tract 4211.01, Baltimore County, Maryland",2850,360,346,96,346,14,877,735,523,335,142,684,502,404,214,182,439,425,346,141,14,490,412,349,72,78
1400000US24005421102,"Census Tract 4211.02, Baltimore County, Maryland",2264,345,291,121,270,54,614,527,353,335,87,770,593,526,180,177,261,212,185,80,49,274,264,251,37,10
1400000US24005421200,"Census Tract 4212, Baltimore County, Maryland",1768,285,273,193,187,12,452,409,274,244,43,219,214,154,77,5,314,283,239,52,31,498,436,436,56,62
1400000US24005421300,"Census Tract 4213, Baltimore County, Maryland",2866,1081,979,262,822,102,842,805,561,373,37,457,419,219,246,38,233,209,209,0,24,253,253,200,90,0
1400000US24005430101,"Census Tract 4301.01, Baltimore County, Maryland",4430,929,737,54,703,192,1357,924,602,437,433,1619,1082,603,614,537,466,371,334,72,95,59,59,53,6,0
1400000US24005430104,"Census Tract 4301.04, Baltimore County, Maryland",2671,309,297,69,275,12,279,275,202,169,4,813,694,542,268,119,350,308,291,140,42,920,907,760,187,13
1400000US24005430200,"Census Tract 4302, Baltimore County, Maryland",2902,658,550,358,342,108,473,445,359,158,28,655,501,501,33,154,275,231,221,75,44,841,816,725,106,25
1400000US24005430300,"Census Tract 4303, Baltimore County, Maryland",6406,1853,1616,337,1377,237,1630,1412,728,799,218,1940,1344,649,789,596,281,269,232,90,12,702,565,479,86,137
1400000US24005430400,"Census Tract 4304, Baltimore County, Maryland",4285,420,325,153,215,95,830,767,568,343,63,860,709,635,191,151,572,552,552,34,20,1603,1426,1333,157,177
1400000US24005430600,"Census Tract 4306, Baltimore County, Maryland",2341,216,180,159,100,36,212,205,193,81,7,589,542,510,100,47,477,430,371,141,47,847,847,774,126,0
1400000US24005430700,"Census Tract 4307, Baltimore County, Maryland",4753,269,226,174,158,43,949,819,574,489,130,840,767,709,132,73,722,722,715,46,0,1973,1926,1856,121,47
1400000US24005430800,"Census Tract 4308, Baltimore County, Maryland",3602,337,242,140,180,95,473,429,404,191,44,774,751,709,200,23,970,881,766,167,89,1048,1012,984,57,36
1400000US24005430900,"Census Tract 4309, Baltimore County, Maryland",4674,565,433,291,185,132,1621,1369,1105,363,252,696,623,609,14,73,872,612,612,40,260,920,771,730,129,149
1400000US24005440100,"Census Tract 4401, Baltimore County, Maryland",4675,532,477,283,396,55,398,387,365,183,11,795,701,684,239,94,1122,1086,1068,109,36,1828,1681,1558,380,147
1400000US24005440200,"Census Tract 4402, Baltimore County, Maryland",2512,342,310,164,254,32,405,398,345,222,7,493,417,387,114,76,519,374,308,145,145,753,680,670,47,73
1400000US24005440300,"Census Tract 4403, Baltimore County, Maryland",2097,387,200,58,152,187,374,307,292,65,67,520,400,333,171,120,269,269,269,0,0,547,547,547,0,0
1400000US24005440400,"Census Tract 4404, Baltimore County, Maryland",5764,337,305,113,246,32,1107,1070,983,537,37,1297,1142,1092,262,155,920,844,672,258,76,2103,2028,1916,423,75
1400000US24005440500,"Census Tract 4405, Baltimore County, Maryland",3029,333,295,213,281,38,430,318,283,182,112,430,338,299,115,92,748,737,737,10,11,1088,997,937,163,91
1400000US24005440600,"Census Tract 4406, Baltimore County, Maryland",2208,106,106,88,66,0,131,116,106,59,15,102,102,98,37,0,374,322,290,67,52,1495,1445,1307,227,50
1400000US24005440701,"Census Tract 4407.01, Baltimore County, Maryland",6442,914,725,276,496,189,1931,1740,1116,681,191,960,880,796,150,80,536,478,369,124,58,2101,1652,1589,109,449
1400000US24005440702,"Census Tract 4407.02, Baltimore County, Maryland",5155,602,602,318,401,0,1095,889,744,453,206,697,649,649,71,48,952,952,943,140,0,1809,1753,1696,82,56
1400000US24005440800,"Census Tract 4408, Baltimore County, Maryland",3128,312,225,102,188,87,790,624,370,273,166,494,463,443,99,31,382,290,290,0,92,1150,1107,1029,117,43
1400000US24005440900,"Census Tract 4409, Baltimore County, Maryland",3593,688,570,138,519,118,1085,944,465,551,141,268,218,218,19,50,608,547,490,69,61,944,891,791,130,53
1400000US24005441000,"Census Tract 4410, Baltimore County, Maryland",3450,526,507,43,492,19,1025,862,551,414,163,722,642,536,193,80,372,344,284,86,28,805,792,722,164,13
1400000US24005441101,"Census Tract 4411.01, Baltimore County, Maryland",2081,205,197,153,142,8,512,345,246,235,167,276,267,224,95,9,311,281,281,78,30,777,777,741,98,0
1400000US24005441102,"Census Tract 4411.02, Baltimore County, Maryland",4574,528,410,255,309,118,595,468,370,313,127,741,642,603,176,99,754,676,662,90,78,1956,1811,1591,395,145
1400000US24005450100,"Census Tract 4501, Baltimore County, Maryland",3799,528,477,324,385,51,764,690,481,387,74,784,735,553,259,49,457,438,272,199,19,1266,1227,1216,62,39
1400000US24005450200,"Census Tract 4502, Baltimore County, Maryland",3414,354,320,146,236,34,961,896,642,564,65,611,494,286,255,117,685,625,546,124,60,803,786,752,94,17
1400000US24005450300,"Census Tract 4503, Baltimore County, Maryland",3255,358,358,272,254,0,475,447,403,251,28,743,595,537,119,148,534,494,386,178,40,1145,1022,980,76,123
1400000US24005450400,"Census Tract 4504, Baltimore County, Maryland",2142,211,148,94,134,63,340,316,206,167,24,368,321,251,121,47,572,537,383,164,35,651,614,592,60,37
1400000US24005450501,"Census Tract 4505.01, Baltimore County, Maryland",4134,727,604,154,538,123,979,882,677,521,97,570,477,354,185,93,686,583,439,195,103,1172,780,696,109,392
1400000US24005450503,"Census Tract 4505.03, Baltimore County, Maryland",5704,608,440,163,356,168,2493,2082,1174,1097,411,1208,944,425,696,264,671,651,641,48,20,724,577,528,78,147
1400000US24005450504,"Census Tract 4505.04, Baltimore County, Maryland",5778,1298,1013,266,812,285,1652,1200,659,727,452,1444,1241,954,319,203,914,849,660,206,65,470,452,441,35,18
1400000US24005450800,"Census Tract 4508, Baltimore County, Maryland",3701,647,566,223,521,81,834,623,508,224,211,675,551,448,205,124,835,724,587,253,111,710,626,614,80,84
1400000US24005450900,"Census Tract 4509, Baltimore County, Maryland",3892,285,217,184,139,68,522,427,402,245,95,564,513,472,162,51,973,951,871,154,22,1548,1514,1410,232,34
1400000US24005451000,"Census Tract 4510, Baltimore County, Maryland",1821,154,145,57,141,9,130,130,97,73,0,299,299,277,129,0,465,322,174,197,143,773,621,592,76,152
1400000US24005451100,"Census Tract 4511, Baltimore County, Maryland",2391,75,75,22,63,0,447,279,218,113,168,400,308,167,175,92,459,427,345,122,32,1010,969,907,133,41
1400000US24005451200,"Census Tract 4512, Baltimore County, Maryland",3990,288,242,165,204,46,976,662,367,509,314,761,739,626,279,22,648,627,540,176,21,1317,1165,1096,116,152
1400000US24005451300,"Census Tract 4513, Baltimore County, Maryland",3082,498,385,135,327,113,897,694,264,517,203,839,596,474,249,243,334,314,239,113,20,514,428,368,121,86
1400000US24005451401,"Census Tract 4514.01, Baltimore County, Maryland",3398,398,253,127,180,145,664,578,424,209,86,624,596,586,41,28,396,313,268,73,83,1316,1277,1179,329,39
1400000US24005451402,"Census Tract 4514.02, Baltimore County, Maryland",6006,1394,743,130,658,651,1481,1164,871,487,317,1352,1130,1048,163,222,906,579,550,42,327,873,868,868,0,5
1400000US24005451500,"Census Tract 4515, Baltimore County, Maryland",4043,228,197,45,197,31,1191,1111,560,639,80,1278,1007,769,290,271,811,811,763,99,0,535,472,435,103,63
1400000US24005451600,"Census Tract 4516, Baltimore County, Maryland",2054,179,150,111,107,29,385,280,247,122,105,443,439,319,240,4,250,241,241,29,9,797,786,764,104,11
1400000US24005451701,"Census Tract 4517.01, Baltimore County, Maryland",2626,195,173,93,153,22,582,542,449,388,40,499,461,409,129,38,295,295,295,52,0,1055,839,694,240,216
1400000US24005451702,"Census Tract 4517.02, Baltimore County, Maryland",2049,198,177,97,157,21,242,204,101,178,38,414,376,358,178,38,194,194,172,63,0,1001,979,939,172,22
1400000US24005451801,"Census Tract 4518.01, Baltimore County, Maryland",5048,645,629,284,474,16,477,477,446,185,0,1135,1049,907,231,86,1030,948,896,119,82,1761,1618,1605,179,143
1400000US24005451802,"Census Tract 4518.02, Baltimore County, Maryland",3452,448,398,254,319,50,735,704,567,386,31,924,844,831,174,80,386,386,370,96,0,959,942,934,89,17
1400000US24005451803,"Census Tract 4518.03, Baltimore County, Maryland",4625,476,359,124,269,117,1140,978,708,405,162,706,659,631,93,47,695,665,617,168,30,1608,1471,1431,74,137
1400000US24005451900,"Census Tract 4519, Baltimore County, Maryland",2436,301,261,81,254,40,440,371,289,166,69,706,608,537,240,98,434,434,400,94,0,555,515,508,56,40
1400000US24005452000,"Census Tract 4520, Baltimore County, Maryland",2364,371,354,250,303,17,447,421,354,172,26,426,347,312,125,79,469,469,437,112,0,651,547,541,35,104
1400000US24005452100,"Census Tract 4521, Baltimore County, Maryland",3449,550,483,195,419,67,806,630,492,373,176,566,533,399,262,33,497,447,409,96,50,1030,1030,1006,74,0
1400000US24005452300,"Census Tract 4523, Baltimore County, Maryland",3071,624,532,166,480,92,626,509,204,416,117,944,786,673,205,158,695,462,439,23,233,182,182,156,36,0
1400000US24005452400,"Census Tract 4524, Baltimore County, Maryland",3367,290,265,82,225,25,700,622,461,392,78,411,381,364,97,30,532,415,399,37,117,1434,1369,1307,202,65
1400000US24005452500,"Census Tract 4525, Baltimore County, Maryland",3819,591,539,197,507,52,955,800,623,473,155,1013,938,725,358,75,688,662,641,80,26,572,537,513,78,35
1400000US24005490100,"Census Tract 4901, Baltimore County, Maryland",4070,412,392,92,386,20,303,298,275,204,5,379,347,347,142,32,336,336,296,135,0,2640,2628,2496,416,12
1400000US24005490200,"Census Tract 4902, Baltimore County, Maryland",2735,192,179,142,152,13,275,257,178,201,18,315,315,304,132,0,522,500,489,76,22,1431,1393,1370,90,38
1400000US24005490301,"Census Tract 4903.01, Baltimore County, Maryland",4788,1402,1143,907,425,259,1023,951,867,263,72,859,677,663,214,182,391,391,391,44,0,1113,1067,981,219,46
1400000US24005490302,"Census Tract 4903.02, Baltimore County, Maryland",2504,275,236,216,210,39,382,330,295,210,52,523,457,377,244,66,250,233,223,103,17,1074,1026,1008,232,48
1400000US24005490400,"Census Tract 4904, Baltimore County, Maryland",1612,65,59,42,28,6,54,49,44,26,5,99,99,67,68,0,134,134,131,104,0,1260,1260,1230,140,0
1400000US24005490500,"Census Tract 4905, Baltimore County, Maryland",3785,147,147,107,97,0,387,349,318,156,38,515,498,437,120,17,297,297,297,108,0,2439,2439,2418,232,0
1400000US24005490601,"Census Tract 4906.01, Baltimore County, Maryland",2068,115,115,90,36,0,147,132,108,52,15,153,153,148,39,0,461,461,451,25,0,1192,1192,1169,101,0
1400000US24005490602,"Census Tract 4906.02, Baltimore County, Maryland",3121,496,438,356,99,58,343,277,260,48,66,721,639,639,55,82,441,435,435,22,6,1120,1090,1065,70,30
1400000US24005490603,"Census Tract 4906.03, Baltimore County, Maryland",2273,37,37,37,27,0,211,211,182,149,0,239,239,239,78,0,339,339,320,42,0,1447,1357,1352,103,90
1400000US24005490605,"Census Tract 4906.05, Baltimore County, Maryland",332,268,249,249,12,19,40,40,40,0,0,24,24,24,0,0,0,0,0,0,0,0,0,0,0,0
1400000US24005490701,"Census Tract 4907.01, Baltimore County, Maryland",1458,189,189,152,147,0,139,131,118,115,8,108,108,95,57,0,138,138,138,79,0,884,884,781,247,0
1400000US24005490703,"Census Tract 4907.03, Baltimore County, Maryland",2610,315,305,222,146,10,173,156,126,63,17,385,312,276,87,73,454,454,454,36,0,1283,1259,1250,83,24
1400000US24005490800,"Census Tract 4908, Baltimore County, Maryland",3356,459,411,333,175,48,314,290,275,78,24,419,404,392,45,15,250,233,213,39,17,1914,1902,1889,176,12
1400000US24005490900,"Census Tract 4909, Baltimore County, Maryland",4530,1220,1026,649,564,194,585,575,518,167,10,951,748,711,113,203,713,459,459,71,254,1061,1061,1061,59,0
1400000US24005491000,"Census Tract 4910, Baltimore County, Maryland",2165,10,10,10,10,0,142,142,137,34,0,129,129,119,96,0,148,148,104,44,0,1736,1736,1731,67,0
1400000US24005491100,"Census Tract 4911, Baltimore County, Maryland",3600,156,80,71,45,76,684,651,390,326,33,442,387,368,56,55,683,629,584,140,54,1635,1603,1589,55,32
1400000US24005491201,"Census Tract 4912.01, Baltimore County, Maryland",1901,115,100,87,72,15,277,250,176,109,27,554,412,375,90,142,316,316,316,84,0,639,639,634,74,0
1400000US24005491202,"Census Tract 4912.02, Baltimore County, Maryland",1751,118,101,87,65,17,355,318,215,161,37,357,357,357,85,0,277,277,277,85,0,644,620,597,86,24
1400000US24005491300,"Census Tract 4913, Baltimore County, Maryland",3209,737,668,554,187,69,514,504,480,142,10,564,485,456,98,79,427,399,366,231,28,967,906,897,101,61
1400000US24005491401,"Census Tract 4914.01, Baltimore County, Maryland",5212,812,589,284,376,223,2072,1718,1238,608,354,1578,1481,1231,348,97,488,447,413,49,41,262,262,223,54,0
1400000US24005491402,"Census Tract 4914.02, Baltimore County, Maryland",3168,501,339,263,190,162,836,720,347,507,116,973,728,456,272,245,389,334,300,34,55,469,390,349,50,79
1400000US24005491500,"Census Tract 4915, Baltimore County, Maryland",3700,1171,803,377,552,368,613,389,217,215,224,559,536,475,157,23,503,463,449,54,40,854,822,771,74,32
1400000US24005491600,"Census Tract 4916, Baltimore County, Maryland",2561,156,105,67,82,51,572,520,496,175,52,846,717,704,114,129,678,468,419,68,210,309,299,299,0,10
1400000US24005491701,"Census Tract 4917.01, Baltimore County, Maryland",3938,366,296,159,193,70,528,463,415,142,65,655,472,408,221,183,877,877,859,42,0,1512,1445,1445,95,67
1400000US24005491900,"Census Tract 4919, Baltimore County, Maryland",1836,135,115,55,93,20,360,345,245,287,15,630,446,346,233,184,297,297,286,77,0,414,400,377,82,14
1400000US24005492001,"Census Tract 4920.01, Baltimore County, Maryland",1450,79,49,34,33,30,368,280,250,131,88,462,447,404,92,15,232,202,202,27,30,309,306,257,71,3
1400000US24005492002,"Census Tract 4920.02, Baltimore County, Maryland",3616,261,234,128,204,27,679,581,398,265,98,641,568,547,112,73,667,656,622,114,11,1368,1200,1102,114,168
1400000US24005492101,"Census Tract 4921.01, Baltimore County, Maryland",3234,441,398,280,278,43,847,781,575,435,66,665,583,529,162,82,519,478,443,147,41,762,659,633,88,103
1400000US24005492102,"Census Tract 4921.02, Baltimore County, Maryland",2252,189,178,108,130,11,345,298,186,175,47,387,365,360,114,22,692,670,599,122,22,639,603,454,154,36
1400000US24005492200,"Census Tract 4922, Baltimore County, Maryland",4612,421,279,184,249,142,921,881,552,525,40,962,962,900,209,0,1254,1204,1157,95,50,1054,1014,1014,0,40
1400000US24005492300,"Census Tract 4923, Baltimore County, Maryland",4173,335,267,108,245,68,1163,914,277,767,249,882,799,607,330,83,742,698,602,167,44,1051,948,837,133,103
1400000US24005492401,"Census Tract 4924.01, Baltimore County, Maryland",3990,199,116,31,88,83,366,316,267,49,50,420,399,235,196,21,756,696,696,57,60,2249,2116,1933,326,133
1400000US24005492402,"Census Tract 4924.02, Baltimore County, Maryland",5918,231,231,149,196,0,953,901,835,207,52,997,964,890,284,33,1291,1214,1214,125,77,2446,2302,2243,207,144
1400000US24005492500,"Census Tract 4925, Baltimore County, Maryland",133,8,8,8,0,0,125,125,115,10,0,0,0,0,0,0,0,0,0,0,0,0,0,0,0,0
1400000US24005492600,"Census Tract 4926, Baltimore County, Maryland",3271,244,213,68,198,31,519,432,312,193,87,616,541,476,113,75,476,460,421,151,16,1416,1279,1257,85,137
1400000US24005980000,"Census Tract 9800, Baltimore County, Maryland",0,0,0,0,0,0,0,0,0,0,0,0,0,0,0,0,0,0,0,0,0,0,0,0,0,0
1400000US24005980100,"Census Tract 9801, Baltimore County, Maryland",0,0,0,0,0,0,0,0,0,0,0,0,0,0,0,0,0,0,0,0,0,0,0,0,0,0
1400000US24005980200,"Census Tract 9802, Baltimore County, Maryland",0,0,0,0,0,0,0,0,0,0,0,0,0,0,0,0,0,0,0,0,0,0,0,0,0,0
1400000US24009860101,"Census Tract 8601.01, Calvert County, Maryland",3226,219,219,172,112,0,157,111,111,87,46,511,446,410,104,65,433,409,368,119,24,1906,1857,1841,147,49
1400000US24009860102,"Census Tract 8601.02, Calvert County, Maryland",2762,82,82,58,24,0,186,186,179,50,0,233,227,211,57,6,356,356,341,136,0,1905,1851,1838,179,54
1400000US24009860200,"Census Tract 8602, Calvert County, Maryland",6250,264,214,179,159,50,504,405,327,156,99,831,776,689,239,55,736,696,602,121,40,3915,3791,3694,372,124
1400000US24009860300,"Census Tract 8603, Calvert County, Maryland",4103,121,121,78,104,0,171,140,140,62,31,486,486,468,90,0,491,481,447,137,10,2834,2775,2624,304,59
1400000US24009860401,"Census Tract 8604.01, Calvert County, Maryland",9398,383,315,213,200,68,1251,1145,767,482,106,1834,1758,1479,585,76,1135,1045,961,151,90,4795,4516,4491,420,279
1400000US24009860402,"Census Tract 8604.02, Calvert County, Maryland",3162,278,278,57,229,0,319,281,254,62,38,552,521,436,157,31,489,480,407,118,9,1524,1459,1404,145,65
1400000US24009860501,"Census Tract 8605.01, Calvert County, Maryland",5720,56,56,47,49,0,172,134,134,57,38,714,632,501,208,82,386,374,341,73,12,4392,4178,4004,369,214
1400000US24009860502,"Census Tract 8605.02, Calvert County, Maryland",3116,298,206,109,113,92,287,251,159,156,36,369,343,343,65,26,324,324,299,75,0,1838,1767,1671,199,71
1400000US24009860600,"Census Tract 8606, Calvert County, Maryland",7407,268,234,172,121,34,367,367,354,174,0,641,588,483,210,53,938,938,761,333,0,5193,5098,5056,422,95
1400000US24009860701,"Census Tract 8607.01, Calvert County, Maryland",2267,200,186,113,145,14,237,201,163,88,36,263,226,193,104,37,496,387,307,153,109,1071,990,990,116,81
1400000US24009860702,"Census Tract 8607.02, Calvert County, Maryland",2996,619,552,181,508,67,292,175,104,132,117,382,343,307,76,39,513,513,490,53,0,1190,1176,1117,145,14
1400000US24009860703,"Census Tract 8607.03, Calvert County, Maryland",3543,458,295,164,185,163,321,256,118,205,65,703,644,573,146,59,496,496,455,60,0,1565,1496,1410,206,69
1400000US24009860801,"Census Tract 8608.01, Calvert County, Maryland",6409,161,143,110,60,18,551,496,362,194,55,599,599,506,177,0,871,851,765,132,20,4227,4026,3838,513,201
1400000US24009860802,"Census Tract 8608.02, Calvert County, Maryland",4912,347,280,149,186,67,549,479,370,236,70,594,556,468,242,38,905,777,752,157,128,2517,2431,2332,222,86
1400000US24009860900,"Census Tract 8609, Calvert County, Maryland",6354,715,602,203,533,113,927,708,590,285,219,1049,944,908,380,105,1442,1363,1112,387,79,2221,2096,1905,570,125
1400000US24009861001,"Census Tract 8610.01, Calvert County, Maryland",1247,57,37,32,13,20,38,38,38,17,0,99,99,99,20,0,282,282,271,51,0,771,732,710,99,39
1400000US24009861003,"Census Tract 8610.03, Calvert County, Maryland",6374,264,218,56,218,46,1062,766,479,402,296,1049,945,802,318,104,1194,1144,1135,132,50,2805,2618,2511,301,187
1400000US24009861004,"Census Tract 8610.04, Calvert County, Maryland",7952,642,578,116,490,64,1114,855,620,416,259,1823,1693,1142,614,130,1689,1592,1533,143,97,2684,2523,2428,321,161
1400000US24009990100,"Census Tract 9901, Calvert County, Maryland",0,0,0,0,0,0,0,0,0,0,0,0,0,0,0,0,0,0,0,0,0,0,0,0,0,0
1400000US24011955000,"Census Tract 9550, Caroline County, Maryland",3211,713,522,67,509,191,671,475,240,334,196,775,482,293,276,293,600,570,565,44,30,452,326,326,21,126
1400000US24011955100,"Census Tract 9551, Caroline County, Maryland",5975,571,515,174,433,56,1295,1174,920,490,121,1561,1358,1080,495,203,1118,1001,936,82,117,1430,1411,1274,216,19
1400000US24011955201,"Census Tract 9552.01, Caroline County, Maryland",3736,440,357,248,314,83,539,517,327,258,22,1076,895,706,322,181,557,553,538,53,4,1124,1083,1014,118,41
1400000US24011955202,"Census Tract 9552.02, Caroline County, Maryland",2432,203,194,158,53,9,476,476,79,422,0,492,429,384,208,63,419,354,342,86,65,842,781,733,115,61
1400000US24011955301,"Census Tract 9553.01, Caroline County, Maryland",3370,264,177,89,151,87,300,248,164,191,52,849,779,675,155,70,587,555,521,97,32,1370,1236,1200,145,134
1400000US24011955302,"Census Tract 9553.02, Caroline County, Maryland",2807,625,598,199,492,27,244,209,133,114,35,472,431,365,112,41,597,528,408,180,69,869,685,540,355,184
1400000US24011955400,"Census Tract 9554, Caroline County, Maryland",2224,293,193,103,136,100,208,204,135,123,4,423,382,231,191,41,467,410,373,50,57,833,664,626,165,169
1400000US24011955500,"Census Tract 9555, Caroline County, Maryland",3995,600,524,228,483,76,748,657,441,384,91,937,842,694,334,95,901,796,664,186,105,809,767,735,118,42
1400000US24011955600,"Census Tract 9556, Caroline County, Maryland",4523,1021,839,156,791,182,1450,1256,753,786,194,839,769,576,313,70,716,559,409,199,157,497,426,403,93,71
1400000US24013501001,"Census Tract 5010.01, Carroll County, Maryland",4576,207,183,138,183,24,724,553,238,397,171,713,713,694,53,0,1098,1082,1048,111,16,1834,1769,1769,70,65
1400000US24013501002,"Census Tract 5010.02, Carroll County, Maryland",5012,741,714,563,305,27,850,788,719,358,62,947,864,828,225,83,712,662,602,273,50,1762,1699,1625,239,63
1400000US24013502000,"Census Tract 5020, Carroll County, Maryland",3910,221,174,102,127,47,617,575,520,271,42,714,584,525,100,130,695,649,641,70,46,1663,1610,1578,153,53
1400000US24013503000,"Census Tract 5030, Carroll County, Maryland",5412,532,490,122,457,42,835,688,580,286,147,787,656,599,186,131,1179,1132,1054,165,47,2079,1961,1932,98,118
1400000US24013504100,"Census Tract 5041, Carroll County, Maryland",5489,129,112,77,83,17,639,527,356,261,112,646,591,529,214,55,940,868,834,150,72,3135,2986,2821,426,149
1400000US24013504201,"Census Tract 5042.01, Carroll County, Maryland",6041,146,127,88,78,19,916,744,604,456,172,971,875,722,348,96,820,820,773,157,0,3188,3134,3054,194,54
1400000US24013504202,"Census Tract 5042.02, Carroll County, Maryland",6009,184,184,123,116,0,468,343,308,107,125,824,669,504,364,155,827,712,667,58,115,3706,3656,3649,262,50
1400000US24013505101,"Census Tract 5051.01, Carroll County, Maryland",4505,109,60,48,60,49,201,160,160,81,41,423,410,346,175,13,670,629,613,132,41,3102,3037,2939,210,65
1400000US24013505102,"Census Tract 5051.02, Carroll County, Maryland",5324,162,124,67,111,38,351,333,268,200,18,616,590,513,172,26,650,604,573,148,46,3545,3510,3485,208,35
1400000US24013505203,"Census Tract 5052.03, Carroll County, Maryland",2799,82,82,48,65,0,175,175,161,96,0,434,408,400,78,26,550,536,536,20,14,1558,1521,1494,104,37
1400000US24013505205,"Census Tract 5052.05, Carroll County, Maryland",3064,80,80,66,14,0,249,236,207,29,13,345,345,345,55,0,381,381,342,91,0,2009,1959,1937,119,50
1400000US24013505206,"Census Tract 5052.06, Carroll County, Maryland",3698,295,279,154,260,16,391,374,347,200,17,203,187,137,78,16,912,903,757,248,9,1897,1861,1783,179,36
1400000US24013505207,"Census Tract 5052.07, Carroll County, Maryland",3770,191,191,113,119,0,326,326,272,127,0,458,435,403,57,23,795,758,752,21,37,2000,2000,1962,106,0
1400000US24013505208,"Census Tract 5052.08, Carroll County, Maryland",5622,355,313,261,160,42,469,469,379,271,0,554,540,443,317,14,1125,1002,887,161,123,3119,3063,2973,247,56
1400000US24013506101,"Census Tract 5061.01, Carroll County, Maryland",4455,265,221,188,148,44,354,327,284,170,27,585,585,521,125,0,1443,1404,1396,98,39,1808,1740,1674,188,68
1400000US24013506102,"Census Tract 5061.02, Carroll County, Maryland",3939,235,191,165,112,44,542,338,327,119,204,313,196,177,52,117,641,589,589,24,52,2208,2169,2155,132,39
1400000US24013506200,"Census Tract 5062, Carroll County, Maryland",4697,277,262,216,191,15,651,627,401,363,24,1132,1030,755,501,102,855,773,751,144,82,1782,1746,1708,224,36
1400000US24013507500,"Census Tract 5075, Carroll County, Maryland",3375,172,148,46,126,24,333,291,270,91,42,329,329,268,111,0,777,710,540,257,67,1764,1658,1563,199,106
1400000US24013507601,"Census Tract 5076.01, Carroll County, Maryland",4792,662,357,100,311,305,653,572,460,190,81,561,526,429,188,35,1026,833,779,217,193,1890,1748,1699,137,142
1400000US24013507602,"Census Tract 5076.02, Carroll County, Maryland",3666,583,411,229,353,172,789,739,564,404,50,458,421,399,70,37,597,572,532,77,25,1239,1197,1169,53,42
1400000US24013507702,"Census Tract 5077.02, Carroll County, Maryland",3887,535,447,257,364,88,607,571,402,328,36,530,507,485,158,23,497,464,354,171,33,1718,1624,1565,139,94
1400000US24013507703,"Census Tract 5077.03, Carroll County, Maryland",2921,246,246,167,218,0,337,326,284,236,11,379,341,341,167,38,572,451,451,66,121,1387,1387,1387,165,0
1400000US24013507704,"Census Tract 5077.04, Carroll County, Maryland",5810,458,368,169,280,90,1243,1124,796,469,119,1009,935,840,219,74,669,659,659,20,10,2431,2364,2243,245,67
1400000US24013507801,"Census Tract 5078.01, Carroll County, Maryland",5522,1256,980,167,962,276,733,646,483,215,87,890,739,511,301,151,728,655,630,115,73,1915,1915,1830,120,0
1400000US24013507802,"Census Tract 5078.02, Carroll County, Maryland",4408,231,223,131,199,8,693,571,466,314,122,509,494,467,246,15,589,502,479,65,87,2386,2319,2234,178,67
1400000US24013508101,"Census Tract 5081.01, Carroll County, Maryland",4581,662,528,291,374,134,317,317,291,178,0,809,775,704,175,34,543,527,505,106,16,2250,2250,2250,120,0
1400000US24013508102,"Census Tract 5081.02, Carroll County, Maryland",3323,172,144,133,134,28,409,345,268,95,64,1061,1061,906,234,0,420,420,370,50,0,1261,1236,1159,123,25
1400000US24013508200,"Census Tract 5082, Carroll County, Maryland",7045,409,333,151,247,76,952,892,657,435,60,907,658,613,122,249,1367,1295,1295,105,72,3410,3318,3278,230,92
1400000US24013509001,"Census Tract 5090.01, Carroll County, Maryland",4258,118,118,70,118,0,264,247,218,150,17,435,435,435,126,0,463,449,409,137,14,2978,2878,2801,231,100
1400000US24013509002,"Census Tract 5090.02, Carroll County, Maryland",2704,109,59,34,51,50,258,200,175,134,58,500,390,370,84,110,289,289,289,28,0,1548,1460,1431,73,88
1400000US24013510000,"Census Tract 5100, Carroll County, Maryland",1127,221,158,132,141,63,135,129,89,54,6,299,291,215,90,8,74,74,67,7,0,398,374,339,60,24
1400000US24013511000,"Census Tract 5110, Carroll County, Maryland",3521,183,153,106,108,30,403,330,238,174,73,717,654,595,286,63,806,803,761,93,3,1412,1333,1307,80,79
1400000US24013512000,"Census Tract 5120, Carroll County, Maryland",1639,231,172,83,133,59,228,180,149,76,48,349,330,252,107,19,213,198,189,17,15,618,580,511,127,38
1400000US24013513001,"Census Tract 5130.01, Carroll County, Maryland",4597,558,531,324,368,27,532,416,386,234,116,487,472,441,130,15,668,656,656,83,12,2352,2257,2241,142,95
1400000US24013513002,"Census Tract 5130.02, Carroll County, Maryland",5174,264,243,179,98,21,232,170,170,62,62,511,445,319,199,66,441,441,429,52,0,3726,3683,3657,206,43
1400000US24013514100,"Census Tract 5141, Carroll County, Maryland",3591,86,86,56,70,0,273,248,204,116,25,390,263,246,104,127,832,774,673,154,58,2010,1961,1885,218,49
1400000US24013514201,"Census Tract 5142.01, Carroll County, Maryland",5286,200,166,120,92,34,478,405,340,214,73,578,534,525,146,44,818,784,771,176,34,3212,2986,2946,169,226
1400000US24013514202,"Census Tract 5142.02, Carroll County, Maryland",3628,148,148,30,148,0,279,235,165,121,44,451,399,288,154,52,481,481,481,56,0,2269,2181,2113,199,88
1400000US24015030100,"Census Tract 301, Cecil County, Maryland",5296,972,577,163,505,395,1094,900,666,487,194,854,814,762,220,40,964,898,854,75,66,1412,1384,1335,164,28
1400000US24015030200,"Census Tract 302, Cecil County, Maryland",5099,395,342,196,226,53,444,421,311,341,23,570,460,375,220,110,1171,1067,1026,56,104,2519,2323,2119,315,196
1400000US24015030400,"Census Tract 304, Cecil County, Maryland",4442,1250,921,209,803,329,1160,1048,652,547,112,899,787,556,289,112,419,311,273,105,108,714,632,594,73,82
1400000US24015030501,"Census Tract 305.01, Cecil County, Maryland",3943,183,148,134,101,35,612,499,454,189,113,844,775,673,189,69,594,594,505,158,0,1710,1642,1552,202,68
1400000US24015030503,"Census Tract 305.03, Cecil County, Maryland",5054,577,577,265,340,0,1396,974,884,276,422,1016,946,828,263,70,755,755,558,265,0,1310,1285,1268,109,25
1400000US24015030505,"Census Tract 305.05, Cecil County, Maryland",3523,354,216,126,149,138,1033,857,678,377,176,630,630,597,137,0,564,549,549,11,15,942,872,799,126,70
1400000US24015030506,"Census Tract 305.06, Cecil County, Maryland",7984,996,877,257,727,119,1157,1066,686,567,91,2383,1839,1517,448,544,1004,945,900,177,59,2444,2335,2323,153,109
1400000US24015030601,"Census Tract 306.01, Cecil County, Maryland",4044,328,246,123,175,82,335,285,189,157,50,782,639,548,218,143,1040,1021,984,142,19,1559,1494,1442,157,65
1400000US24015030602,"Census Tract 306.02, Cecil County, Maryland",5171,101,92,55,52,9,1125,1024,640,488,101,678,596,506,182,82,1035,967,765,279,68,2232,2110,2036,287,122
1400000US24015030700,"Census Tract 307, Cecil County, Maryland",5296,265,220,108,198,45,936,741,643,224,195,1072,1032,830,362,40,704,653,613,147,51,2319,2208,2084,273,111
1400000US24015030903,"Census Tract 309.03, Cecil County, Maryland",4167,593,540,165,503,53,829,656,469,446,173,1289,1131,782,398,158,948,853,741,190,95,508,444,418,65,64
1400000US24015030904,"Census Tract 309.04, Cecil County, Maryland",6676,266,266,175,248,0,806,775,660,370,31,1025,684,502,230,341,1089,981,897,201,108,3490,3275,3070,440,215
1400000US24015030905,"Census Tract 309.05, Cecil County, Maryland",2830,776,681,27,681,95,309,280,216,194,29,558,558,347,229,0,481,431,376,65,50,706,694,637,88,12
1400000US24015030906,"Census Tract 309.06, Cecil County, Maryland",8928,1472,1271,549,948,201,1619,1477,1063,765,142,1374,1197,1180,85,177,1502,1404,1402,55,98,2961,2841,2687,340,120
1400000US24015031201,"Census Tract 312.01, Cecil County, Maryland",6937,761,722,197,656,39,1473,1276,888,627,197,1345,1216,1030,316,129,692,662,651,106,30,2666,2571,2201,690,95
1400000US24015031202,"Census Tract 312.02, Cecil County, Maryland",5025,1110,986,323,734,124,791,553,352,332,238,963,848,741,345,115,605,567,476,141,38,1556,1549,1518,125,7
1400000US24015031301,"Census Tract 313.01, Cecil County, Maryland",3851,329,296,105,210,33,614,481,340,222,133,806,714,673,210,92,514,476,438,105,38,1588,1348,1285,214,240
1400000US24015031302,"Census Tract 313.02, Cecil County, Maryland",6820,759,680,352,481,79,1260,1155,658,713,105,1258,1144,1088,113,114,1123,1108,985,342,15,2420,2346,2247,122,74
1400000US24015031400,"Census Tract 314, Cecil County, Maryland",4155,472,353,141,266,119,363,344,311,249,19,712,657,593,201,55,999,876,876,98,123,1609,1534,1395,261,75
1400000US24017850101,"Census Tract 8501.01, Charles County, Maryland",5585,257,232,121,123,25,620,521,396,210,99,786,673,531,340,113,1033,997,971,122,36,2889,2889,2744,359,0
1400000US24017850102,"Census Tract 8501.02, Charles County, Maryland",2719,294,239,59,215,55,322,244,52,233,78,704,622,622,120,82,563,563,558,132,0,836,756,711,69,80
1400000US24017850201,"Census Tract 8502.01, Charles County, Maryland",692,10,10,7,10,0,59,59,59,0,0,158,158,146,24,0,73,66,66,0,7,392,316,256,60,76
1400000US24017850202,"Census Tract 8502.02, Charles County, Maryland",4828,570,522,230,391,48,701,619,577,145,82,1184,1120,979,229,64,877,848,753,142,29,1496,1426,1408,135,70
1400000US24017850300,"Census Tract 8503, Charles County, Maryland",2204,263,240,77,192,23,258,221,210,152,37,217,217,143,129,0,294,294,256,96,0,1172,1116,1107,113,56
1400000US24017850400,"Census Tract 8504, Charles County, Maryland",3654,427,339,144,268,88,524,402,210,296,122,580,477,379,259,103,434,434,383,135,0,1689,1666,1582,241,23
1400000US24017850500,"Census Tract 8505, Charles County, Maryland",2771,93,83,54,77,10,164,141,91,58,23,248,192,192,94,56,242,206,181,78,36,2024,1969,1941,304,55
1400000US24017850600,"Census Tract 8506, Charles County, Maryland",4203,117,84,49,75,33,298,183,161,114,115,627,483,307,227,144,643,619,574,134,24,2518,2492,2359,405,26
1400000US24017850706,"Census Tract 8507.06, Charles County, Maryland",5097,593,523,160,371,70,450,366,333,55,84,88,88,88,0,0,1310,1135,1065,273,175,2656,2581,2554,165,75
1400000US24017850708,"Census Tract 8507.08, Charles County, Maryland",5076,90,90,66,51,0,85,85,85,22,0,361,310,310,44,51,631,612,603,60,19,3909,3807,3751,300,102
1400000US24017850709,"Census Tract 8507.09, Charles County, Maryland",7126,651,514,331,304,137,554,539,501,146,15,1892,1577,1294,316,315,1835,1767,1638,246,68,2194,1963,1865,283,231
1400000US24017850710,"Census Tract 8507.10, Charles County, Maryland",5573,111,111,111,10,0,254,242,88,170,12,606,389,285,156,217,676,668,668,35,8,3926,3869,3789,258,57
1400000US24017850711,"Census Tract 8507.11, Charles County, Maryland",4790,309,309,229,143,0,890,837,580,406,53,1389,1189,924,309,200,660,648,619,29,12,1542,1386,1345,146,156
1400000US24017850712,"Census Tract 8507.12, Charles County, Maryland",5572,182,182,131,159,0,162,123,87,56,39,676,661,647,48,15,403,403,403,50,0,4149,4018,3867,527,131
1400000US24017850713,"Census Tract 8507.13, Charles County, Maryland",6695,285,285,251,48,0,410,278,255,121,132,949,878,784,175,71,658,504,487,354,154,4393,4283,4212,434,110
1400000US24017850801,"Census Tract 8508.01, Charles County, Maryland",4800,165,153,153,78,12,263,183,178,43,80,859,834,643,291,25,430,352,352,72,78,3083,2965,2760,477,118
1400000US24017850802,"Census Tract 8508.02, Charles County, Maryland",3814,314,253,70,198,61,764,663,434,325,101,600,398,342,97,202,753,691,691,115,62,1383,1355,1349,47,28
1400000US24017850901,"Census Tract 8509.01, Charles County, Maryland",5714,1416,1218,379,1018,198,1144,1041,789,433,103,399,383,292,154,16,737,694,553,177,43,2018,1860,1814,164,158
1400000US24017850902,"Census Tract 8509.02, Charles County, Maryland",5524,272,237,157,131,35,520,477,355,304,43,972,781,531,367,191,1004,804,756,179,200,2756,2408,2262,319,348
1400000US24017850904,"Census Tract 8509.04, Charles County, Maryland",5479,184,184,111,128,0,108,101,101,93,7,745,745,745,48,0,830,809,752,90,21,3612,3478,3429,271,134
1400000US24017850905,"Census Tract 8509.05, Charles County, Maryland",4395,271,254,86,182,17,379,289,244,88,90,715,674,592,118,41,647,512,421,91,135,2383,2312,2188,300,71
1400000US24017850906,"Census Tract 8509.06, Charles County, Maryland",4676,986,836,506,504,150,1125,986,666,429,139,629,614,614,76,15,533,533,448,107,0,1403,1317,1224,149,86
1400000US24017851001,"Census Tract 8510.01, Charles County, Maryland",2727,117,117,47,117,0,161,150,107,99,11,190,190,190,50,0,752,653,610,94,99,1507,1446,1436,332,61
1400000US24017851002,"Census Tract 8510.02, Charles County, Maryland",8855,953,840,362,656,113,626,481,364,226,145,1572,1525,1373,310,47,1157,1098,942,260,59,4547,4411,4381,566,136
1400000US24033800505,"Census Tract 8005.05, Prince George's County, Maryland",2644,130,92,75,42,38,460,315,160,233,145,313,256,230,88,57,486,448,448,92,38,1255,1213,1202,98,42
1400000US24033800507,"Census Tract 8005.07, Prince George's County, Maryland",2862,103,103,48,72,0,77,49,49,0,28,502,457,350,158,45,542,509,483,68,33,1638,1513,1492,144,125
1400000US24033800509,"Census Tract 8005.09, Prince George's County, Maryland",8785,441,376,219,251,65,527,406,328,198,121,903,890,791,453,13,1950,1938,1785,414,12,4964,4759,4711,472,205
1400000US24033800511,"Census Tract 8005.11, Prince George's County, Maryland",4932,80,80,71,28,0,442,422,370,128,20,854,788,655,206,66,896,843,843,83,53,2660,2577,2468,334,83
1400000US24033800513,"Census Tract 8005.13, Prince George's County, Maryland",5358,138,127,43,110,11,436,367,222,239,69,956,833,826,96,123,1189,1080,1023,112,109,2639,2556,2437,357,83
1400000US24033800514,"Census Tract 8005.14, Prince George's County, Maryland",4691,59,0,0,0,59,83,83,50,55,0,151,151,151,0,0,165,137,137,12,28,4233,4044,3816,404,189
1400000US24033800515,"Census Tract 8005.15, Prince George's County, Maryland",3963,158,158,12,158,0,632,498,364,221,134,601,573,452,142,28,843,780,780,34,63,1729,1657,1650,125,72
1400000US24033800516,"Census Tract 8005.16, Prince George's County, Maryland",3496,198,172,125,152,26,448,410,371,119,38,531,436,334,233,95,424,392,379,35,32,1895,1861,1789,133,34
1400000US24033800517,"Census Tract 8005.17, Prince George's County, Maryland",4960,103,0,0,0,103,78,78,78,40,0,637,617,453,255,20,209,209,194,15,0,3933,3786,3628,376,147
1400000US24033800518,"Census Tract 8005.18, Prince George's County, Maryland",3153,109,88,73,62,21,53,28,28,12,25,145,136,136,7,9,268,245,245,12,23,2578,2485,2367,232,93
1400000US24033800519,"Census Tract 8005.19, Prince George's County, Maryland",3966,117,105,79,39,12,243,206,132,164,37,604,547,547,22,57,368,341,333,61,27,2634,2465,2399,111,169
1400000US24033800520,"Census Tract 8005.20, Prince George's County, Maryland",1882,8,8,8,8,0,109,67,67,26,42,325,289,229,113,36,385,347,347,0,38,1055,1010,1010,30,45
1400000US24033800601,"Census Tract 8006.01, Prince George's County, Maryland",2030,142,142,136,41,0,104,99,91,57,5,307,262,183,118,45,153,153,153,49,0,1324,1233,1210,160,91
1400000US24033800604,"Census Tract 8006.04, Prince George's County, Maryland",1477,33,33,10,28,0,224,131,43,100,93,91,91,91,45,0,251,251,251,15,0,878,771,731,124,107
1400000US24033800605,"Census Tract 8006.05, Prince George's County, Maryland",4208,50,39,34,30,11,221,156,149,36,65,623,386,307,118,237,442,431,392,75,11,2872,2770,2686,233,102
1400000US24033800606,"Census Tract 8006.06, Prince George's County, Maryland",4718,237,177,177,34,60,567,481,481,45,86,1054,885,885,69,169,1303,1179,1143,63,124,1557,1420,1404,118,137
1400000US24033800607,"Census Tract 8006.07, Prince George's County, Maryland",6207,137,137,83,107,0,200,163,131,94,37,833,595,359,246,238,467,467,450,41,0,4570,4351,4168,588,219
1400000US24033800608,"Census Tract 8006.08, Prince George's County, Maryland",3466,46,46,46,5,0,40,35,35,10,5,417,339,311,81,78,88,88,88,0,0,2875,2742,2561,383,133
1400000US24033800701,"Census Tract 8007.01, Prince George's County, Maryland",4915,0,0,0,0,0,360,296,277,63,64,407,394,375,190,13,892,892,879,33,0,3256,3130,3035,294,126
1400000US24033800704,"Census Tract 8007.04, Prince George's County, Maryland",4936,69,53,53,25,16,623,600,513,163,23,851,802,759,82,49,929,913,875,83,16,2464,2331,2246,301,133
1400000US24033800705,"Census Tract 8007.05, Prince George's County, Maryland",4345,188,188,59,188,0,415,380,356,47,35,265,195,195,93,70,624,463,453,53,161,2853,2819,2751,271,34
1400000US24033800706,"Census Tract 8007.06, Prince George's County, Maryland",3786,0,0,0,0,0,42,42,17,25,0,460,396,396,129,64,590,543,480,80,47,2694,2546,2448,221,148
1400000US24033800707,"Census Tract 8007.07, Prince George's County, Maryland",2591,381,360,300,131,21,234,234,177,129,0,121,121,121,47,0,251,251,230,110,0,1604,1556,1518,288,48
1400000US24033800800,"Census Tract 8008, Prince George's County, Maryland",3445,53,44,21,44,9,344,344,274,152,0,308,262,236,140,46,437,399,329,117,38,2303,2274,2203,337,29
1400000US24033800900,"Census Tract 8009, Prince George's County, Maryland",1455,134,105,39,87,29,332,288,230,102,44,169,131,115,39,38,221,190,190,80,31,599,592,592,62,7
1400000US24033801003,"Census Tract 8010.03, Prince George's County, Maryland",4205,160,117,71,82,43,530,499,475,107,31,750,584,415,240,166,235,194,178,32,41,2530,2233,2010,366,297
1400000US24033801004,"Census Tract 8010.04, Prince George's County, Maryland",4170,48,48,12,48,0,324,324,290,150,0,374,337,281,89,37,466,455,455,56,11,2958,2876,2821,265,82
1400000US24033801005,"Census Tract 8010.05, Prince George's County, Maryland",4045,110,64,52,36,46,179,159,123,118,20,209,202,195,23,7,701,648,537,167,53,2846,2610,2534,271,236
1400000US24033801006,"Census Tract 8010.06, Prince George's County, Maryland",4063,141,30,14,23,111,344,270,161,154,74,276,266,259,39,10,826,719,672,112,107,2476,2419,2367,155,57
1400000US24033801104,"Census Tract 8011.04, Prince George's County, Maryland",2320,266,220,193,27,46,710,710,710,15,0,529,529,529,0,0,304,304,222,104,0,511,505,505,18,6
1400000US24033801207,"Census Tract 8012.07, Prince George's County, Maryland",4366,89,51,33,43,38,215,209,194,58,6,448,427,337,176,21,561,487,392,237,74,3053,2978,2946,318,75
1400000US24033801208,"Census Tract 8012.08, Prince George's County, Maryland",3646,0,0,0,0,0,334,244,97,186,90,214,214,208,49,0,680,659,631,100,21,2418,2300,2159,357,118
1400000US24033801209,"Census Tract 8012.09, Prince George's County, Maryland",4385,307,269,58,250,38,169,134,79,105,35,568,530,396,189,38,1048,982,755,326,66,2293,2219,1758,563,74
1400000US24033801210,"Census Tract 8012.10, Prince George's County, Maryland",4399,287,276,47,239,11,709,413,130,300,296,478,419,371,158,59,671,482,459,136,189,2254,2179,2163,292,75
1400000US24033801211,"Census Tract 8012.11, Prince George's County, Maryland",2930,92,82,71,82,10,491,460,395,166,31,311,279,204,202,32,503,503,480,207,0,1533,1533,1469,164,0
1400000US24033801212,"Census Tract 8012.12, Prince George's County, Maryland",3355,109,81,25,73,28,129,120,120,13,9,525,446,366,199,79,889,730,703,126,159,1703,1540,1328,441,163
1400000US24033801213,"Census Tract 8012.13, Prince George's County, Maryland",3583,168,147,82,102,21,146,130,98,98,16,718,673,599,306,45,763,604,541,199,159,1788,1654,1591,481,134
1400000US24033801214,"Census Tract 8012.14, Prince George's County, Maryland",3730,475,461,295,359,14,313,302,272,159,11,389,308,286,113,81,827,783,758,146,44,1726,1584,1483,235,142
1400000US24033801215,"Census Tract 8012.15, Prince George's County, Maryland",2284,11,11,11,0,0,95,62,62,22,33,392,329,285,178,63,313,313,174,165,0,1473,1416,1393,56,57
1400000US24033801216,"Census Tract 8012.16, Prince George's County, Maryland",3233,161,134,86,118,27,226,226,138,133,0,721,615,567,149,106,814,652,560,221,162,1311,1184,1131,260,127
1400000US24033801217,"Census Tract 8012.17, Prince George's County, Maryland",3520,196,170,136,92,26,105,105,105,80,0,317,278,223,68,39,774,706,660,140,68,2128,1945,1796,458,183
1400000US24033801302,"Census Tract 8013.02, Prince George's County, Maryland",2685,69,33,20,18,36,250,224,179,103,26,170,157,115,99,13,396,377,370,61,19,1800,1768,1713,240,32
1400000US24033801305,"Census Tract 8013.05, Prince George's County, Maryland",5494,66,66,38,55,0,624,534,490,260,90,494,463,463,124,31,1262,1084,1044,178,178,3048,2857,2681,451,191
1400000US24033801307,"Census Tract 8013.07, Prince George's County, Maryland",3713,132,96,52,89,36,224,163,110,123,61,330,305,254,124,25,358,340,306,102,18,2669,2547,2445,531,122
1400000US24033801308,"Census Tract 8013.08, Prince George's County, Maryland",3900,65,40,40,30,25,301,280,248,66,21,277,277,264,91,0,730,657,563,122,73,2527,2386,2281,418,141
1400000US24033801309,"Census Tract 8013.09, Prince George's County, Maryland",3842,130,96,67,46,34,125,106,92,84,19,105,105,105,62,0,738,637,637,37,101,2744,2607,2555,497,137
1400000US24033801310,"Census Tract 8013.10, Prince George's County, Maryland",5880,104,104,82,39,0,678,591,553,172,87,315,299,292,141,16,452,446,424,60,6,4331,4237,4121,513,94
1400000US24033801311,"Census Tract 8013.11, Prince George's County, Maryland",6038,607,546,252,307,61,437,410,305,231,27,954,758,651,205,196,807,745,579,228,62,3233,2876,2714,290,357
1400000US24033801312,"Census Tract 8013.12, Prince George's County, Maryland",3391,264,181,168,33,83,542,530,445,350,12,829,590,513,130,239,382,350,211,248,32,1374,1361,1361,143,13
1400000US24033801313,"Census Tract 8013.13, Prince George's County, Maryland",3013,260,260,70,211,0,152,152,108,96,0,426,374,353,56,52,167,167,127,72,0,2008,1875,1875,156,133
1400000US24033801404,"Census Tract 8014.04, Prince George's County, Maryland",4773,468,380,109,289,88,619,394,345,132,225,986,938,805,294,48,865,680,559,177,185,1835,1662,1603,355,173
1400000US24033801405,"Census Tract 8014.05, Prince George's County, Maryland",5104,618,469,228,335,149,572,447,330,191,125,1090,859,622,377,231,1105,614,561,115,491,1719,1182,1097,186,537
1400000US24033801406,"Census Tract 8014.06, Prince George's County, Maryland",2698,356,312,169,260,44,410,273,188,123,137,683,604,570,102,79,241,229,211,38,12,1008,924,888,207,84
1400000US24033801407,"Census Tract 8014.07, Prince George's County, Maryland",6237,353,353,143,283,0,986,898,702,348,88,879,811,626,352,68,1344,1173,1062,306,171,2675,2417,2342,278,258
1400000US24033801408,"Census Tract 8014.08, Prince George's County, Maryland",3844,149,149,135,37,0,906,828,556,340,78,908,908,813,168,0,974,954,918,121,20,907,873,800,159,34
1400000US24033801409,"Census Tract 8014.09, Prince George's County, Maryland",2909,138,138,101,125,0,563,454,386,177,109,815,666,510,206,149,517,459,435,86,58,876,876,844,173,0
1400000US24033801410,"Census Tract 8014.10, Prince George's County, Maryland",3581,211,129,129,40,82,77,77,77,10,0,322,322,296,169,0,499,443,394,144,56,2472,2259,2103,523,213
1400000US24033801411,"Census Tract 8014.11, Prince George's County, Maryland",3422,78,78,0,78,0,509,501,378,178,8,823,723,613,200,100,433,328,304,80,105,1579,1556,1516,323,23
1400000US24033801500,"Census Tract 8015, Prince George's County, Maryland",2149,141,83,52,58,58,297,285,143,200,12,650,462,378,186,188,445,417,363,111,28,616,548,480,104,68
1400000US24033801600,"Census Tract 8016, Prince George's County, Maryland",2414,254,202,101,163,52,554,518,287,340,36,530,472,352,224,58,753,649,559,134,104,323,323,323,39,0
1400000US24033801701,"Census Tract 8017.01, Prince George's County, Maryland",3818,543,488,201,346,55,517,492,439,83,25,840,729,562,218,111,741,646,624,90,95,1177,1078,886,291,99
1400000US24033801702,"Census Tract 8017.02, Prince George's County, Maryland",3863,708,548,225,359,160,873,722,416,338,151,771,746,696,105,25,448,366,285,96,82,1063,985,753,343,78
1400000US24033801704,"Census Tract 8017.04, Prince George's County, Maryland",5861,690,593,179,427,97,1524,1368,916,673,156,1521,1228,896,419,293,690,624,552,173,66,1436,1419,1419,168,17
1400000US24033801706,"Census Tract 8017.06, Prince George's County, Maryland",1665,148,74,61,13,74,533,352,147,222,181,300,276,264,40,24,268,251,190,124,17,416,331,300,31,85
1400000US24033801707,"Census Tract 8017.07, Prince George's County, Maryland",6033,641,361,39,347,280,1398,1288,960,479,110,1337,1058,805,354,279,807,588,350,292,219,1850,1587,1384,414,263
1400000US24033801708,"Census Tract 8017.08, Prince George's County, Maryland",3766,233,203,37,173,30,911,690,425,363,221,461,363,363,20,98,734,499,375,198,235,1427,1122,1047,161,305
1400000US24033801801,"Census Tract 8018.01, Prince George's County, Maryland",2225,313,197,110,138,116,747,673,511,166,74,538,405,387,61,133,242,236,204,75,6,385,349,246,107,36
1400000US24033801802,"Census Tract 8018.02, Prince George's County, Maryland",3248,380,350,216,248,30,747,573,390,248,174,1108,996,829,247,112,690,579,540,100,111,323,280,264,51,43
1400000US24033801804,"Census Tract 8018.04, Prince George's County, Maryland",2031,178,128,78,75,50,179,146,46,113,33,450,333,328,161,117,293,278,274,26,15,931,816,782,137,115
1400000US24033801805,"Census Tract 8018.05, Prince George's County, Maryland",2459,276,222,74,183,54,761,735,506,291,26,745,454,423,80,291,434,398,324,103,36,243,229,224,45,14
1400000US24033801807,"Census Tract 8018.07, Prince George's County, Maryland",4288,424,387,153,327,37,805,726,543,215,79,995,924,771,264,71,386,294,279,28,92,1678,1559,1384,217,119
1400000US24033801808,"Census Tract 8018.08, Prince George's County, Maryland",3709,361,194,40,154,167,1087,829,671,242,258,838,770,656,232,68,407,396,305,138,11,1016,970,916,190,46
1400000US24033801901,"Census Tract 8019.01, Prince George's County, Maryland",4909,249,228,192,125,21,541,390,264,257,151,705,650,464,372,55,691,691,477,299,0,2723,2609,2510,509,114
1400000US24033801904,"Census Tract 8019.04, Prince George's County, Maryland",3317,289,165,142,114,124,733,606,362,283,127,725,530,451,163,195,515,473,427,59,42,1055,835,812,166,220
1400000US24033801905,"Census Tract 8019.05, Prince George's County, Maryland",5061,145,108,81,64,37,548,454,362,167,94,878,614,531,114,264,1009,881,847,135,128,2481,2314,2208,312,167
1400000US24033801906,"Census Tract 8019.06, Prince George's County, Maryland",2043,265,249,174,204,16,451,277,211,88,174,425,371,351,79,54,311,283,237,80,28,591,504,409,145,87
1400000US24033801907,"Census Tract 8019.07, Prince George's County, Maryland",3245,381,339,184,304,42,595,581,529,212,14,608,535,518,64,73,583,478,331,237,105,1078,1019,998,88,59
1400000US24033801908,"Census Tract 8019.08, Prince George's County, Maryland",3579,294,238,166,84,56,1064,916,735,354,148,990,919,877,199,71,798,761,606,155,37,433,363,245,118,70
1400000US24033802001,"Census Tract 8020.01, Prince George's County, Maryland",5455,524,408,119,318,116,1492,1278,1129,439,214,1458,1353,1148,383,105,569,554,505,49,15,1412,1121,1072,110,291
1400000US24033802002,"Census Tract 8020.02, Prince George's County, Maryland",3772,375,336,48,308,39,728,644,446,330,84,707,597,478,218,110,989,936,900,92,53,973,826,806,60,147
1400000US24033802103,"Census Tract 8021.03, Prince George's County, Maryland",2931,108,92,60,50,16,377,333,262,145,44,448,426,417,91,22,490,480,415,65,10,1508,1419,1341,233,89
1400000US24033802104,"Census Tract 8021.04, Prince George's County, Maryland",1640,171,148,47,136,23,716,660,535,209,56,320,264,242,38,56,163,136,136,31,27,270,245,145,105,25
1400000US24033802106,"Census Tract 8021.06, Prince George's County, Maryland",3981,530,269,49,220,261,1021,828,365,485,193,987,878,708,191,109,258,221,221,46,37,1185,1129,1002,142,56
1400000US24033802107,"Census Tract 8021.07, Prince George's County, Maryland",4181,558,407,51,382,151,1144,979,541,469,165,980,925,817,150,55,776,642,619,52,134,723,546,404,154,177
1400000US24033802201,"Census Tract 8022.01, Prince George's County, Maryland",1638,249,110,46,93,139,152,105,88,39,47,673,542,501,125,131,278,278,251,56,0,286,279,279,0,7
1400000US24033802203,"Census Tract 8022.03, Prince George's County, Maryland",4293,425,360,195,233,65,1266,980,512,603,286,618,398,331,127,220,648,586,517,105,62,1336,1055,889,191,281
1400000US24033802204,"Census Tract 8022.04, Prince George's County, Maryland",5763,358,342,284,105,16,456,409,265,341,47,1379,1110,1023,375,269,1146,1044,1020,122,102,2424,2277,2119,393,147
1400000US24033802301,"Census Tract 8023.01, Prince George's County, Maryland",4077,230,116,108,57,114,393,337,177,241,56,800,796,693,305,4,996,906,769,250,90,1658,1344,1222,384,314
1400000US24033802404,"Census Tract 8024.04, Prince George's County, Maryland",4449,791,725,135,657,66,1142,981,629,468,161,1356,1243,967,391,113,311,290,290,0,21,849,821,768,97,28
1400000US24033802405,"Census Tract 8024.05, Prince George's County, Maryland",3945,559,500,132,396,59,772,669,594,216,103,1056,951,798,304,105,604,514,394,129,90,954,931,823,209,23
1400000US24033802406,"Census Tract 8024.06, Prince George's County, Maryland",2324,515,447,50,414,68,306,263,161,155,43,484,431,229,220,53,393,326,276,65,67,626,558,455,204,68
1400000US24033802407,"Census Tract 8024.07, Prince George's County, Maryland",4105,527,386,215,218,141,1339,1189,893,429,150,1172,1129,883,333,43,254,232,232,0,22,813,708,674,80,105
1400000US24033802408,"Census Tract 8024.08, Prince George's County, Maryland",1509,299,248,44,221,51,461,386,315,71,75,192,89,89,0,103,257,222,178,44,35,300,292,283,12,8
1400000US24033802501,"Census Tract 8025.01, Prince George's County, Maryland",2905,253,226,147,117,27,965,841,522,398,124,637,582,542,59,55,537,482,482,46,55,513,442,391,132,71
1400000US24033802502,"Census Tract 8025.02, Prince George's County, Maryland",2587,330,311,124,225,19,371,298,189,139,73,726,505,428,152,221,455,403,248,161,52,705,678,654,92,27
1400000US24033802600,"Census Tract 8026, Prince George's County, Maryland",2903,373,358,239,245,15,553,530,423,186,23,839,657,411,370,182,544,487,373,152,57,594,553,537,68,41
1400000US24033802700,"Census Tract 8027, Prince George's County, Maryland",2345,552,388,84,375,164,366,314,177,191,52,581,494,404,172,87,268,254,216,44,14,578,433,373,116,145
1400000US24033802803,"Census Tract 8028.03, Prince George's County, Maryland",4334,725,662,125,643,63,849,803,627,271,46,630,615,532,189,15,688,607,553,148,81,1442,1409,1355,128,33
1400000US24033802804,"Census Tract 8028.04, Prince George's County, Maryland",5341,780,654,259,531,126,628,599,525,194,29,1642,1499,1248,527,143,945,841,759,202,104,1346,1265,1240,145,81
1400000US24033802805,"Census Tract 8028.05, Prince George's County, Maryland",4906,699,570,147,486,129,1132,949,470,586,183,946,806,585,385,140,708,653,623,109,55,1421,1230,1097,308,191
1400000US24033802901,"Census Tract 8029.01, Prince George's County, Maryland",3697,1029,842,110,808,187,590,526,294,348,64,757,683,539,264,74,296,260,260,6,36,1025,959,888,204,66
1400000US24033803001,"Census Tract 8030.01, Prince George's County, Maryland",2769,186,113,40,98,73,341,250,183,95,91,650,524,473,175,126,651,577,449,158,74,941,813,801,32,128
1400000US24033803002,"Census Tract 8030.02, Prince George's County, Maryland",2734,317,317,60,304,0,539,459,303,217,80,791,777,613,232,14,482,466,466,47,16,605,580,553,81,25
1400000US24033803100,"Census Tract 8031, Prince George's County, Maryland",2241,188,128,86,88,60,375,348,275,127,27,510,466,412,133,44,429,404,398,78,25,739,656,586,154,83
1400000US24033803200,"Census Tract 8032, Prince George's County, Maryland",3033,409,288,94,199,121,879,707,400,385,172,935,839,787,73,96,392,302,295,31,90,418,390,390,11,28
1400000US24033803300,"Census Tract 8033, Prince George's County, Maryland",4448,469,434,201,265,35,628,504,388,239,124,1160,988,817,294,172,1105,998,820,209,107,1086,1010,939,198,76
1400000US24033803401,"Census Tract 8034.01, Prince George's County, Maryland",1421,158,92,10,89,66,386,334,243,120,52,217,96,96,15,121,335,310,263,75,25,325,279,169,126,46
1400000US24033803402,"Census Tract 8034.02, Prince George's County, Maryland",4418,941,745,301,586,196,605,570,395,209,35,1287,1158,871,352,129,591,547,432,302,44,994,877,792,208,117
1400000US24033803508,"Census Tract 8035.08, Prince George's County, Maryland",4585,1212,1058,210,898,154,1080,827,607,282,253,1000,788,572,283,212,307,282,275,17,25,986,811,778,123,175
1400000US24033803509,"Census Tract 8035.09, Prince George's County, Maryland",3024,251,222,79,187,29,1253,923,414,567,330,867,710,523,238,157,292,243,169,82,49,361,320,287,71,41
1400000US24033803512,"Census Tract 8035.12, Prince George's County, Maryland",5852,436,426,426,28,10,443,443,405,133,0,1094,989,898,211,105,1176,1048,954,124,128,2703,2351,2296,240,352
1400000US24033803513,"Census Tract 8035.13, Prince George's County, Maryland",4281,509,408,150,313,101,371,355,324,125,16,1132,966,684,380,166,730,713,699,52,17,1539,1404,1372,190,135
1400000US24033803514,"Census Tract 8035.14, Prince George's County, Maryland",4363,427,413,322,136,14,952,930,587,397,22,536,462,425,37,74,423,423,418,5,0,2025,1958,1818,243,67
1400000US24033803516,"Census Tract 8035.16, Prince George's County, Maryland",4636,30,30,30,30,0,269,236,170,97,33,663,517,432,112,146,630,585,572,28,45,3044,2813,2699,233,231
1400000US24033803519,"Census Tract 8035.19, Prince George's County, Maryland",3907,209,194,145,153,15,473,435,359,192,38,524,473,430,69,51,1191,1014,786,228,177,1510,1457,1280,256,53
1400000US24033803520,"Census Tract 8035.20, Prince George's County, Maryland",3830,89,89,22,67,0,264,264,195,107,0,629,374,365,48,255,487,409,390,94,78,2361,2307,2231,302,54
1400000US24033803521,"Census Tract 8035.21, Prince George's County, Maryland",4620,149,149,106,124,0,437,323,186,224,114,612,557,418,321,55,638,580,524,201,58,2784,2613,2551,282,171
1400000US24033803522,"Census Tract 8035.22, Prince George's County, Maryland",3634,65,53,53,18,12,290,260,208,82,30,569,544,538,75,25,567,528,528,39,39,2143,2043,1973,144,100
1400000US24033803523,"Census Tract 8035.23, Prince George's County, Maryland",3946,0,0,0,0,0,179,133,72,92,46,709,491,336,218,218,498,498,466,169,0,2560,2411,2341,359,149
1400000US24033803524,"Census Tract 8035.24, Prince George's County, Maryland",3741,49,49,49,14,0,573,442,361,121,131,948,865,707,158,83,925,873,831,80,52,1246,1198,1076,166,48
1400000US24033803525,"Census Tract 8035.25, Prince George's County, Maryland",2541,537,452,57,395,85,566,525,465,83,41,655,418,303,115,237,122,122,122,13,0,661,637,622,19,24
1400000US24033803526,"Census Tract 8035.26, Prince George's County, Maryland",3347,206,185,96,100,21,397,381,233,221,16,891,759,647,203,132,483,412,397,103,71,1370,1297,1253,115,73
1400000US24033803527,"Census Tract 8035.27, Prince George's County, Maryland",3209,101,55,55,0,46,383,311,204,121,72,465,429,429,49,36,377,334,309,110,43,1883,1772,1707,191,111
1400000US24033803601,"Census Tract 8036.01, Prince George's County, Maryland",3880,27,27,22,5,0,451,346,234,212,105,613,513,462,161,100,733,705,611,227,28,2056,2031,1922,339,25
1400000US24033803602,"Census Tract 8036.02, Prince George's County, Maryland",1896,262,234,83,189,28,288,234,176,100,54,323,318,277,69,5,322,277,248,118,45,701,650,638,201,51
1400000US24033803605,"Census Tract 8036.05, Prince George's County, Maryland",6956,241,223,152,127,18,1031,897,630,531,134,1310,904,645,389,406,1647,1343,777,658,304,2727,2235,1958,571,492
1400000US24033803606,"Census Tract 8036.06, Prince George's County, Maryland",4866,299,155,101,139,144,365,258,197,124,107,1074,978,719,393,96,909,813,602,286,96,2219,2155,1948,300,64
1400000US24033803607,"Census Tract 8036.07, Prince George's County, Maryland",3468,127,105,27,96,22,130,130,130,63,0,677,590,499,164,87,539,465,454,60,74,1995,1899,1676,330,96
1400000US24033803608,"Census Tract 8036.08, Prince George's County, Maryland",5277,364,269,163,220,95,1231,748,311,517,483,1331,1135,887,393,196,793,719,642,184,74,1558,1376,1297,256,182
1400000US24033803610,"Census Tract 8036.10, Prince George's County, Maryland",2854,216,118,85,71,98,1045,531,320,295,514,361,269,231,77,92,259,193,193,39,66,973,911,883,112,62
1400000US24033803612,"Census Tract 8036.12, Prince George's County, Maryland",2983,348,301,58,243,47,1052,862,505,420,190,651,603,476,132,48,277,237,221,16,40,655,514,514,0,141
1400000US24033803613,"Census Tract 8036.13, Prince George's County, Maryland",4834,297,202,67,167,95,1389,1146,919,327,243,1798,1380,1240,235,418,877,610,495,187,267,473,405,394,66,68
1400000US24033803700,"Census Tract 8037, Prince George's County, Maryland",2590,197,147,90,100,50,525,368,159,215,157,690,582,444,186,108,546,407,331,94,139,632,577,537,51,55
1400000US24033803801,"Census Tract 8038.01, Prince George's County, Maryland",2508,146,92,13,83,54,451,316,230,125,135,743,526,244,335,217,450,304,221,121,146,718,662,505,214,56
1400000US24033803803,"Census Tract 8038.03, Prince George's County, Maryland",5293,474,371,100,313,103,831,673,493,236,158,966,774,691,144,192,1069,915,797,239,154,1953,1460,1364,157,493
1400000US24033803900,"Census Tract 8039, Prince George's County, Maryland",4132,353,168,29,151,185,546,330,190,172,216,1092,512,325,197,580,1057,591,433,203,466,1084,795,645,216,289
1400000US24033804001,"Census Tract 8040.01, Prince George's County, Maryland",5235,1306,1121,355,890,185,1215,839,600,291,376,1419,1087,777,331,332,625,496,465,31,129,670,612,579,152,58
1400000US24033804002,"Census Tract 8040.02, Prince George's County, Maryland",3943,277,214,75,173,63,1484,787,377,521,697,796,538,473,119,258,965,640,617,124,325,421,393,393,11,28
1400000US24033804101,"Census Tract 8041.01, Prince George's County, Maryland",3171,407,303,109,203,104,520,387,323,78,133,506,411,334,84,95,427,427,427,0,0,1311,1189,1083,134,122
1400000US24033804102,"Census Tract 8041.02, Prince George's County, Maryland",5913,524,423,81,398,101,1756,1438,871,735,318,1387,1039,733,437,348,771,636,617,52,135,1475,1278,1169,109,197
1400000US24033804200,"Census Tract 8042, Prince George's County, Maryland",2900,80,72,62,35,8,86,71,63,27,15,444,348,253,152,96,645,611,571,173,34,1645,1574,1574,98,71
1400000US24033804300,"Census Tract 8043, Prince George's County, Maryland",3560,690,552,189,450,138,828,657,382,325,171,841,638,495,244,203,339,220,131,89,119,862,570,544,47,292
1400000US24033804400,"Census Tract 8044, Prince George's County, Maryland",2616,313,241,85,173,72,406,319,221,158,87,799,628,377,306,171,258,226,180,54,32,840,632,518,167,208
1400000US24033804600,"Census Tract 8046, Prince George's County, Maryland",2955,392,236,111,177,156,722,493,358,188,229,716,474,219,282,242,398,306,265,105,92,727,585,421,215,142
1400000US24033804700,"Census Tract 8047, Prince George's County, Maryland",3557,406,193,49,148,213,355,229,119,143,126,700,451,282,213,249,135,130,105,32,5,1961,1612,1445,229,349
1400000US24033804801,"Census Tract 8048.01, Prince George's County, Maryland",2232,329,174,152,22,155,1180,1006,701,349,174,539,502,502,0,37,164,91,91,0,73,20,13,13,0,7
1400000US24033804802,"Census Tract 8048.02, Prince George's County, Maryland",2982,843,295,63,264,548,986,735,395,344,251,630,376,231,180,254,91,78,78,0,13,432,85,85,19,347
1400000US24033804900,"Census Tract 8049, Prince George's County, Maryland",3841,573,481,145,398,92,1180,866,680,301,314,557,486,421,129,71,672,607,581,104,65,859,767,737,126,92
1400000US24033805000,"Census Tract 8050, Prince George's County, Maryland",5528,551,491,390,228,60,762,442,303,284,320,593,507,487,47,86,1018,774,575,258,244,2604,1872,1604,455,732
1400000US24033805101,"Census Tract 8051.01, Prince George's County, Maryland",3817,376,208,50,166,168,1227,751,456,362,476,961,537,377,160,424,509,246,166,80,263,744,464,433,69,280
1400000US24033805201,"Census Tract 8052.01, Prince George's County, Maryland",4397,492,265,82,214,227,1430,1091,495,813,339,978,624,482,220,354,771,596,548,116,175,726,648,482,266,78
1400000US24033805202,"Census Tract 8052.02, Prince George's County, Maryland",3622,263,196,61,161,67,957,551,305,307,406,797,610,486,156,187,502,415,271,144,87,1103,811,676,202,292
1400000US24033805500,"Census Tract 8055, Prince George's County, Maryland",4215,236,63,48,49,173,855,438,209,248,417,494,336,256,89,158,1077,548,407,170,529,1553,975,721,274,578
1400000US24033805601,"Census Tract 8056.01, Prince George's County, Maryland",6758,1078,395,30,365,683,2311,844,253,669,1467,1674,457,129,340,1217,853,198,119,79,655,842,149,122,27,693
1400000US24033805602,"Census Tract 8056.02, Prince George's County, Maryland",5632,550,215,40,175,335,844,360,217,149,484,2121,584,218,366,1537,601,330,241,126,271,1516,255,73,182,1261
1400000US24033805700,"Census Tract 8057, Prince George's County, Maryland",5990,635,384,199,227,251,1432,781,402,435,651,1547,1097,744,439,450,859,657,612,66,202,1517,730,536,205,787
1400000US24033805801,"Census Tract 8058.01, Prince George's County, Maryland",4568,139,102,70,60,37,623,328,98,288,295,829,561,264,387,268,1128,696,561,180,432,1849,1107,798,391,742
1400000US24033805802,"Census Tract 8058.02, Prince George's County, Maryland",4191,519,251,9,251,268,987,609,313,333,378,665,262,195,118,403,671,416,359,94,255,1349,1043,862,229,306
1400000US24033805904,"Census Tract 8059.04, Prince George's County, Maryland",3129,240,205,102,153,35,1100,887,497,416,213,685,512,256,274,173,550,367,256,182,183,554,488,468,134,66
1400000US24033805906,"Census Tract 8059.06, Prince George's County, Maryland",3081,358,247,157,118,111,1322,715,244,514,607,760,513,324,219,247,298,232,158,74,66,343,296,235,79,47
1400000US24033805907,"Census Tract 8059.07, Prince George's County, Maryland",3731,412,180,102,141,232,948,497,252,275,451,1174,643,424,223,531,614,552,552,19,62,583,443,316,161,140
1400000US24033805908,"Census Tract 8059.08, Prince George's County, Maryland",2666,328,124,69,74,204,649,380,285,142,269,342,296,273,23,46,207,167,126,47,40,1140,542,444,130,598
1400000US24033805909,"Census Tract 8059.09, Prince George's County, Maryland",4488,647,474,404,70,173,1837,1247,878,413,590,842,686,461,264,156,229,217,217,0,12,933,811,787,72,122
1400000US24033806000,"Census Tract 8060, Prince George's County, Maryland",5388,449,253,145,170,196,1336,695,471,403,641,960,649,456,228,311,1189,887,659,271,302,1454,859,627,269,595
1400000US24033806100,"Census Tract 8061, Prince George's County, Maryland",3990,267,103,65,54,164,815,632,457,230,183,724,539,276,305,185,767,646,532,178,121,1417,1355,1283,137,62
1400000US24033806200,"Census Tract 8062, Prince George's County, Maryland",3852,359,326,115,255,33,502,351,192,200,151,463,326,224,114,137,602,544,530,52,58,1926,1479,1208,329,447
1400000US24033806300,"Census Tract 8063, Prince George's County, Maryland",1969,129,73,31,56,56,551,393,222,180,158,394,256,239,25,138,355,316,296,34,39,540,387,339,68,153
1400000US24033806400,"Census Tract 8064, Prince George's County, Maryland",3483,208,135,135,6,73,510,460,438,105,50,178,167,159,22,11,327,320,312,44,7,2260,2239,2188,323,21
1400000US24033806501,"Census Tract 8065.01, Prince George's County, Maryland",5390,570,277,28,266,293,1503,851,220,640,652,1349,920,529,457,429,325,244,244,6,81,1643,1142,980,167,501
1400000US24033806601,"Census Tract 8066.01, Prince George's County, Maryland",4577,469,243,10,243,226,1070,521,247,297,549,899,534,320,214,365,817,533,399,187,284,1322,914,711,283,408
1400000US24033806602,"Census Tract 8066.02, Prince George's County, Maryland",4657,1011,869,172,705,142,658,496,307,244,162,1128,800,405,450,328,871,625,391,275,246,989,828,783,57,161
1400000US24510110100,"Census Tract 1101, Baltimore city, Maryland",3006,877,643,556,87,234,885,777,722,112,108,710,639,602,81,71,248,176,176,0,72,286,286,286,62,0
1400000US24510110200,"Census Tract 1102, Baltimore city, Maryland",4987,1687,1396,715,924,291,900,861,760,231,39,990,897,842,86,93,360,339,314,25,21,1050,1036,860,300,14
1400000US24510120100,"Census Tract 1201, Baltimore city, Maryland",4736,854,805,670,162,49,989,938,913,255,51,603,603,520,160,0,432,432,432,55,0,1858,1858,1830,315,0
1400000US24510120201,"Census Tract 1202.01, Baltimore city, Maryland",2184,532,467,461,26,65,407,321,307,56,86,256,256,250,21,0,443,425,372,53,18,546,546,546,26,0
1400000US24510120202,"Census Tract 1202.02, Baltimore city, Maryland",3796,1772,1704,1338,389,68,673,635,585,50,38,665,462,351,174,203,81,81,81,0,0,605,605,554,51,0
1400000US24510120300,"Census Tract 1203, Baltimore city, Maryland",3140,790,643,277,535,147,610,543,439,154,67,971,910,385,603,61,323,323,308,41,0,446,428,370,94,18
1400000US24510120400,"Census Tract 1204, Baltimore city, Maryland",1331,427,372,98,301,55,372,300,150,199,72,399,319,317,79,80,10,10,10,0,0,123,108,100,20,15
1400000US24510120500,"Census Tract 1205, Baltimore city, Maryland",2022,587,434,158,296,153,608,486,373,254,122,350,248,201,47,102,240,240,180,75,0,237,217,165,64,20
1400000US24510120600,"Census Tract 1206, Baltimore city, Maryland",2464,1266,1109,185,1035,157,523,412,264,173,111,158,130,117,13,28,284,225,207,18,59,233,233,226,51,0
1400000US24510120700,"Census Tract 1207, Baltimore city, Maryland",2239,416,317,115,214,99,578,547,326,288,31,628,485,256,305,143,234,234,234,8,0,383,368,368,0,15
1400000US24510130100,"Census Tract 1301, Baltimore city, Maryland",2651,1337,1073,197,950,264,687,597,372,305,90,204,187,159,28,17,93,68,68,17,25,330,303,277,74,27
1400000US24510130200,"Census Tract 1302, Baltimore city, Maryland",3522,1206,1066,107,1010,140,873,743,305,506,130,526,444,313,131,82,10,10,10,10,0,907,859,545,369,48
1400000US24510130300,"Census Tract 1303, Baltimore city, Maryland",2164,788,689,392,492,99,702,572,239,385,130,400,386,356,94,14,132,117,105,12,15,142,142,142,0,0
1400000US24510130400,"Census Tract 1304, Baltimore city, Maryland",1838,660,564,176,553,96,408,369,206,280,39,408,279,197,95,129,18,18,18,0,0,344,344,167,206,0
1400000US24510130600,"Census Tract 1306, Baltimore city, Maryland",3865,591,527,385,203,64,961,756,584,339,205,578,559,506,103,19,592,497,413,84,95,1143,1040,958,125,103
1400000US24510130700,"Census Tract 1307, Baltimore city, Maryland",4870,693,591,229,524,102,1182,807,562,370,375,817,806,723,169,11,835,723,723,69,112,1343,1343,1280,260,0
1400000US24510130803,"Census Tract 1308.03, Baltimore city, Maryland",2500,210,179,88,144,31,516,386,223,250,130,801,751,659,144,50,349,339,339,20,10,624,620,607,28,4
1400000US24510130804,"Census Tract 1308.04, Baltimore city, Maryland",1890,428,194,158,80,234,349,306,297,76,43,336,293,281,38,43,201,138,111,44,63,576,563,527,36,13
1400000US24510130805,"Census Tract 1308.05, Baltimore city, Maryland",1077,233,204,85,204,29,97,73,47,54,24,168,168,168,29,0,139,133,133,12,6,440,433,419,74,7
1400000US24510130806,"Census Tract 1308.06, Baltimore city, Maryland",1369,236,151,42,142,85,331,304,229,98,27,214,214,214,63,0,227,227,227,0,0,361,323,311,54,38
1400000US24510140100,"Census Tract 1401, Baltimore city, Maryland",4411,1544,1497,737,935,47,674,639,568,161,35,220,205,205,84,15,235,235,235,29,0,1738,1672,1617,204,66
1400000US24510140200,"Census Tract 1402, Baltimore city, Maryland",2698,2088,1847,362,1757,241,278,240,83,178,38,134,112,81,38,22,19,19,19,0,0,179,179,110,79,0
1400000US24510140300,"Census Tract 1403, Baltimore city, Maryland",2432,894,736,101,706,158,705,660,287,422,45,440,418,223,251,22,281,172,123,131,109,112,92,74,24,20
1400000US24510150100,"Census Tract 1501, Baltimore city, Maryland",3166,1678,1480,295,1271,198,822,549,247,343,273,359,114,106,30,245,144,103,103,63,41,163,143,143,44,20
1400000US24510150200,"Census Tract 1502, Baltimore city, Maryland",2774,943,754,118,754,189,462,402,181,269,60,841,773,400,422,68,507,362,102,277,145,21,14,14,5,7
1400000US24510150300,"Census Tract 1503, Baltimore city, Maryland",2564,823,591,127,484,232,784,555,325,244,229,564,457,367,118,107,152,122,114,25,30,241,163,146,51,78
1400000US24510150400,"Census Tract 1504, Baltimore city, Maryland",2910,512,466,211,437,46,1112,967,349,763,145,423,394,301,142,29,316,309,262,62,7,547,351,254,97,196
1400000US24510150500,"Census Tract 1505, Baltimore city, Maryland",2231,877,684,172,630,193,257,186,94,134,71,750,640,448,197,110,200,194,163,78,6,147,138,122,31,9
1400000US24510150600,"Census Tract 1506, Baltimore city, Maryland",2379,823,487,139,408,336,867,779,531,391,88,403,358,199,188,45,99,67,37,36,32,187,157,110,62,30
1400000US24510150701,"Census Tract 1507.01, Baltimore city, Maryland",1417,94,87,22,74,7,494,442,426,125,52,334,300,94,216,34,132,132,120,40,0,363,363,322,66,0
1400000US24510150702,"Census Tract 1507.02, Baltimore city, Maryland",1845,321,305,172,243,16,531,426,189,273,105,446,372,372,152,74,208,123,104,48,85,339,282,215,119,57
1400000US24510150800,"Census Tract 1508, Baltimore city, Maryland",4045,1159,907,196,798,252,1285,1099,749,549,186,770,755,564,263,15,191,163,157,6,28,640,580,483,204,60
1400000US24510150900,"Census Tract 1509, Baltimore city, Maryland",2346,688,536,212,486,152,509,302,194,192,207,137,137,79,77,0,269,258,241,36,11,743,658,593,129,85
1400000US24510151000,"Census Tract 1510, Baltimore city, Maryland",4758,1474,1281,348,1105,193,1358,1198,576,835,160,610,470,331,237,140,259,212,140,129,47,1057,827,758,161,230
1400000US24510151100,"Census Tract 1511, Baltimore city, Maryland",6961,1718,1348,639,1021,370,1848,1444,762,941,404,1607,1534,1403,457,73,782,638,564,236,144,1006,898,799,254,108
1400000US24510151200,"Census Tract 1512, Baltimore city, Maryland",4881,1943,1691,217,1572,252,2003,1837,731,1228,166,556,499,369,200,57,286,235,223,67,51,93,93,93,6,0
1400000US24510151300,"Census Tract 1513, Baltimore city, Maryland",4985,1818,1561,495,1254,257,1419,1221,828,582,198,872,782,533,359,90,502,363,197,180,139,374,368,239,191,6
1400000US24510160100,"Census Tract 1601, Baltimore city, Maryland",2486,1678,1337,214,1277,341,387,329,208,163,58,202,166,114,52,36,83,72,72,27,11,136,130,130,24,6
1400000US24510160200,"Census Tract 1602, Baltimore city, Maryland",2686,816,700,126,666,116,977,833,354,484,144,649,580,396,317,69,210,162,151,11,48,34,34,34,18,0
1400000US24510160300,"Census Tract 1603, Baltimore city, Maryland",1372,566,549,78,508,17,409,314,168,169,95,191,169,135,39,22,0,0,0,0,0,206,206,122,126,0
1400000US24510160400,"Census Tract 1604, Baltimore city, Maryland",3043,980,763,186,668,217,534,444,199,328,90,792,637,324,449,155,252,252,201,112,0,485,414,172,260,71
1400000US24510160500,"Census Tract 1605, Baltimore city, Maryland",3487,1225,1004,470,772,221,668,564,360,330,104,1155,1084,697,516,71,232,232,213,41,0,207,186,159,75,21
1400000US24510160600,"Census Tract 1606, Baltimore city, Maryland",2661,1038,902,195,809,136,613,548,306,325,65,599,484,363,230,115,149,123,77,64,26,262,147,30,133,115
1400000US24510160700,"Census Tract 1607, Baltimore city, Maryland",4713,2077,1795,323,1594,282,844,734,337,491,110,616,533,322,351,83,736,598,398,240,138,440,383,323,144,57
1400000US24510160801,"Census Tract 1608.01, Baltimore city, Maryland",3465,846,628,83,593,218,972,799,616,355,173,724,522,193,368,202,811,631,498,204,180,112,112,112,0,0
1400000US24510160802,"Census Tract 1608.02, Baltimore city, Maryland",3342,1544,1017,282,848,527,871,756,341,554,115,301,253,176,141,48,203,203,124,79,0,423,385,357,65,38
1400000US24510170100,"Census Tract 1701, Baltimore city, Maryland",1552,681,563,115,512,118,451,293,260,108,158,158,147,114,33,11,107,96,59,37,11,155,155,155,0,0
1400000US24510170200,"Census Tract 1702, Baltimore city, Maryland",3604,2175,2012,308,1868,163,1103,1024,205,923,79,243,243,122,134,0,57,57,0,57,0,26,26,26,11,0
1400000US24510170300,"Census Tract 1703, Baltimore city, Maryland",2158,984,902,191,805,82,303,256,110,169,47,422,390,210,195,32,12,12,9,10,0,437,389,288,101,48
1400000US24510180100,"Census Tract 1801, Baltimore city, Maryland",2070,1239,1033,157,973,206,583,530,134,439,53,44,35,35,0,9,55,55,32,23,0,149,144,113,31,5
1400000US24510180200,"Census Tract 1802, Baltimore city, Maryland",796,498,437,207,379,61,141,117,65,79,24,106,62,49,33,44,32,32,32,0,0,19,19,19,0,0
1400000US24510180300,"Census Tract 1803, Baltimore city, Maryland",1589,805,662,157,505,143,183,137,66,84,46,141,119,119,0,22,254,221,221,0,33,206,206,163,49,0
1400000US24510190100,"Census Tract 1901, Baltimore city, Maryland",2069,730,663,68,654,67,599,537,166,446,62,523,433,309,253,90,138,128,66,77,10,79,62,21,41,17
1400000US24510190200,"Census Tract 1902, Baltimore city, Maryland",1971,658,529,84,455,129,276,255,187,76,21,359,228,175,117,131,100,100,100,33,0,578,532,514,38,46
1400000US24510190300,"Census Tract 1903, Baltimore city, Maryland",1720,715,563,126,503,152,714,471,258,213,243,111,111,102,15,0,28,28,17,11,0,152,97,63,43,55
1400000US24510200100,"Census Tract 2001, Baltimore city, Maryland",1874,528,408,73,389,120,625,508,196,345,117,278,238,192,62,40,302,254,236,34,48,141,99,92,7,42
1400000US24510200200,"Census Tract 2002, Baltimore city, Maryland",2000,741,660,213,580,81,603,486,215,360,117,157,150,124,53,7,319,319,287,43,0,180,152,69,83,28
1400000US24510200300,"Census Tract 2003, Baltimore city, Maryland",1810,835,674,159,567,161,694,578,170,450,116,55,50,32,18,5,0,0,0,0,0,226,219,163,204,7
1400000US24510200400,"Census Tract 2004, Baltimore city, Maryland",1828,890,766,116,717,124,354,316,162,199,38,420,272,175,151,148,82,78,46,32,4,82,76,76,0,6
1400000US24510200500,"Census Tract 2005, Baltimore city, Maryland",3020,928,661,143,623,267,1303,1037,425,848,266,332,269,183,122,63,280,207,179,68,73,177,125,125,73,52
1400000US24510200600,"Census Tract 2006, Baltimore city, Maryland",2942,1319,1099,230,962,220,671,485,263,287,186,351,225,185,131,126,292,276,255,51,16,309,265,204,61,44
1400000US24510200701,"Census Tract 2007.01, Baltimore city, Maryland",3907,1191,1079,472,983,112,1095,979,653,547,116,1090,1021,550,642,69,288,288,254,80,0,243,243,235,8,0
1400000US24510200702,"Census Tract 2007.02, Baltimore city, Maryland",1373,431,374,69,357,57,338,282,154,203,56,239,239,207,84,0,129,129,129,0,0,236,212,212,0,24
1400000US24510200800,"Census Tract 2008, Baltimore city, Maryland",2293,673,493,87,425,180,628,505,183,364,123,465,447,303,166,18,231,202,110,114,29,296,296,222,89,0
1400000US24510210100,"Census Tract 2101, Baltimore city, Maryland",2047,739,669,303,398,70,417,312,127,200,105,396,322,322,28,74,131,131,131,4,0,364,337,321,23,27
1400000US24510210200,"Census Tract 2102, Baltimore city, Maryland",3564,883,712,258,508,171,1287,1125,486,722,162,415,341,291,81,74,531,367,357,47,164,448,448,448,7,0
1400000US24510220100,"Census Tract 2201, Baltimore city, Maryland",3721,927,927,462,679,0,386,372,309,134,14,321,274,242,89,47,515,515,515,15,0,1572,1463,1449,113,109
1400000US24510230100,"Census Tract 2301, Baltimore city, Maryland",1952,525,495,179,334,30,355,355,303,81,0,102,102,102,0,0,289,289,289,14,0,681,660,660,16,21
1400000US24510230200,"Census Tract 2302, Baltimore city, Maryland",1869,140,129,51,129,11,181,151,138,45,30,443,437,408,38,6,272,214,203,19,58,833,780,759,21,53
1400000US24510230300,"Census Tract 2303, Baltimore city, Maryland",965,157,93,51,69,64,281,244,120,124,37,232,183,183,9,49,128,104,104,0,24,167,159,156,15,8
1400000US24510240100,"Census Tract 2401, Baltimore city, Maryland",2569,141,141,56,132,0,327,238,206,108,89,320,271,212,108,49,293,293,293,51,0,1488,1480,1480,22,8
1400000US24510240200,"Census Tract 2402, Baltimore city, Maryland",2687,105,99,86,22,6,207,198,198,75,9,407,381,346,69,26,311,268,268,10,43,1657,1600,1553,137,57
1400000US24510240300,"Census Tract 2403, Baltimore city, Maryland",1904,287,217,133,127,70,25,25,25,0,0,248,248,248,8,0,101,101,88,21,0,1243,1221,1213,26,22
1400000US24510240400,"Census Tract 2404, Baltimore city, Maryland",2612,204,180,135,93,24,301,283,236,107,18,473,374,336,72,99,425,393,368,53,32,1209,1208,1202,51,1
1400000US24510250101,"Census Tract 2501.01, Baltimore city, Maryland",3820,390,300,100,211,90,1365,1130,526,694,235,806,717,535,198,89,713,713,516,297,0,546,546,512,34,0
1400000US24510250102,"Census Tract 2501.02, Baltimore city, Maryland",2858,889,777,264,608,112,911,840,491,395,71,428,364,319,83,64,501,439,394,55,62,129,81,67,14,48
1400000US24510250103,"Census Tract 2501.03, Baltimore city, Maryland",3885,654,572,150,544,82,872,756,390,584,116,943,692,603,118,251,477,463,421,84,14,939,784,707,171,155
1400000US24510250203,"Census Tract 2502.03, Baltimore city, Maryland",2304,613,576,88,555,37,625,576,406,275,49,514,439,230,252,75,330,274,215,133,56,222,180,120,127,42
1400000US24510250204,"Census Tract 2502.04, Baltimore city, Maryland",4939,3322,3111,288,2979,211,1313,979,437,700,334,277,265,236,60,12,27,27,27,0,0,0,0,0,0,0
1400000US24510250205,"Census Tract 2502.05, Baltimore city, Maryland",4840,837,761,157,646,76,1775,1429,669,834,346,975,599,455,221,376,918,670,535,198,248,335,292,146,154,43
1400000US24510250206,"Census Tract 2502.06, Baltimore city, Maryland",2515,355,262,71,239,93,475,398,199,259,77,894,705,576,211,189,411,321,240,91,90,380,314,257,62,66
1400000US24510250207,"Census Tract 2502.07, Baltimore city, Maryland",2661,725,627,112,583,98,984,856,444,463,128,434,346,302,60,88,212,212,127,105,0,306,252,174,123,54
1400000US24510250301,"Census Tract 2503.01, Baltimore city, Maryland",2585,989,913,214,779,76,488,424,270,279,64,263,191,100,91,72,309,289,222,81,20,536,502,494,31,34
1400000US24510250303,"Census Tract 2503.03, Baltimore city, Maryland",2035,421,279,95,260,142,713,422,224,300,291,351,326,181,155,25,231,174,98,120,57,319,290,236,111,29
1400000US24510250401,"Census Tract 2504.01, Baltimore city, Maryland",3400,1134,1018,155,946,116,1014,767,491,360,247,629,465,381,155,164,163,163,111,68,0,460,417,385,82,43
1400000US24510250402,"Census Tract 2504.02, Baltimore city, Maryland",5742,1870,1510,173,1385,360,2032,1534,769,898,498,1195,1100,716,462,95,423,263,210,93,160,222,195,71,124,27
1400000US24510250500,"Census Tract 2505, Baltimore city, Maryland",4824,1022,732,225,583,290,1418,1050,554,545,368,1334,1078,778,426,256,556,474,223,291,82,494,340,340,58,154
1400000US24510250600,"Census Tract 2506, Baltimore city, Maryland",0,0,0,0,0,0,0,0,0,0,0,0,0,0,0,0,0,0,0,0,0,0,0,0,0,0
1400000US24510260101,"Census Tract 2601.01, Baltimore city, Maryland",4954,1033,819,362,532,214,1288,962,704,352,326,1228,1147,768,503,81,673,564,555,36,109,732,713,635,105,19
1400000US24510260102,"Census Tract 2601.02, Baltimore city, Maryland",5069,642,597,198,504,45,1713,1522,998,663,191,1438,1307,1146,254,131,715,605,514,172,110,561,470,446,45,91
1400000US24510260201,"Census Tract 2602.01, Baltimore city, Maryland",4978,949,684,190,589,265,1748,1569,767,929,179,1126,993,938,89,133,804,774,514,304,30,351,290,277,30,61
1400000US24510260202,"Census Tract 2602.02, Baltimore city, Maryland",5648,2157,1569,699,1014,588,1163,904,666,373,259,958,797,439,375,161,895,895,810,224,0,475,415,359,133,60
1400000US24510260203,"Census Tract 2602.03, Baltimore city, Maryland",2580,615,559,116,512,56,624,494,319,234,130,471,387,258,163,84,809,668,547,136,141,61,61,61,0,0
1400000US24510260301,"Census Tract 2603.01, Baltimore city, Maryland",4571,1244,1074,185,951,170,1175,1056,753,413,119,1238,1084,909,244,154,192,143,135,57,49,722,702,603,145,20
1400000US24510260302,"Census Tract 2603.02, Baltimore city, Maryland",6469,929,781,260,614,148,1770,1473,779,918,297,2052,1552,1224,460,500,1119,1081,967,226,38,599,515,515,20,84
1400000US24510260303,"Census Tract 2603.03, Baltimore city, Maryland",624,291,220,80,170,71,127,127,115,12,0,104,84,34,62,20,90,78,46,67,12,12,12,12,0,0
1400000US24510260401,"Census Tract 2604.01, Baltimore city, Maryland",3279,1146,1007,242,935,139,1118,726,563,331,392,312,200,155,76,112,402,285,250,83,117,301,173,119,94,128
1400000US24510260402,"Census Tract 2604.02, Baltimore city, Maryland",2415,527,465,247,247,62,520,483,388,95,37,446,413,346,92,33,520,477,477,15,43,402,360,360,23,42
1400000US24510260403,"Census Tract 2604.03, Baltimore city, Maryland",2136,496,348,103,251,148,668,577,388,196,91,423,379,362,37,44,384,356,356,0,28,165,128,120,8,37
1400000US24510260404,"Census Tract 2604.04, Baltimore city, Maryland",2369,321,206,33,192,115,557,245,103,159,312,742,529,196,411,213,230,198,45,153,32,519,233,160,86,286
1400000US24510260501,"Census Tract 2605.01, Baltimore city, Maryland",4974,1047,680,379,552,367,868,711,397,410,157,1136,713,514,258,423,669,527,514,50,142,1254,827,611,291,427
1400000US24510260604,"Census Tract 2606.04, Baltimore city, Maryland",1146,656,610,66,595,46,326,218,125,115,108,147,102,18,84,45,0,0,0,0,0,17,12,12,7,5
1400000US24510260605,"Census Tract 2606.05, Baltimore city, Maryland",4589,1012,802,290,672,210,1265,933,498,571,332,1038,846,567,383,192,685,625,572,79,60,589,533,466,136,56
1400000US24510260700,"Census Tract 2607, Baltimore city, Maryland",2344,535,423,167,307,112,1053,613,245,430,440,317,133,83,96,184,213,100,90,14,113,226,42,42,0,184
1400000US24510260800,"Census Tract 2608, Baltimore city, Maryland",2864,684,478,29,478,206,1173,784,346,506,389,529,315,222,107,214,319,46,46,5,273,159,73,54,31,86
1400000US24510260900,"Census Tract 2609, Baltimore city, Maryland",2442,248,241,120,191,7,240,205,188,33,35,463,383,323,83,80,501,299,299,119,202,990,908,908,24,82
1400000US24510261000,"Census Tract 2610, Baltimore city, Maryland",3093,977,635,152,513,342,916,549,273,430,367,308,210,188,22,98,336,180,106,74,156,556,374,214,198,182
1400000US24510261100,"Census Tract 2611, Baltimore city, Maryland",1838,244,176,96,139,68,164,152,132,44,12,212,177,170,11,35,188,178,178,18,10,1030,995,985,54,35
1400000US24510270101,"Census Tract 2701.01, Baltimore city, Maryland",1825,430,242,55,231,188,338,330,158,239,8,361,350,350,65,11,184,169,141,36,15,512,449,432,39,63
1400000US24510270102,"Census Tract 2701.02, Baltimore city, Maryland",3535,281,272,119,211,9,1080,830,587,365,250,838,790,661,208,48,952,889,818,150,63,384,384,368,29,0
1400000US24510270200,"Census Tract 2702, Baltimore city, Maryland",1800,72,61,54,30,11,346,308,195,123,38,369,340,335,74,29,109,93,83,17,16,904,810,773,68,94
1400000US24510270301,"Census Tract 2703.01, Baltimore city, Maryland",2861,291,216,120,184,75,482,420,330,159,62,729,673,606,130,56,799,697,515,276,102,560,512,480,63,48
1400000US24510270302,"Census Tract 2703.02, Baltimore city, Maryland",1571,112,94,34,65,18,402,280,233,145,122,267,246,166,101,21,258,226,226,0,32,532,473,448,97,59
1400000US24510270401,"Census Tract 2704.01, Baltimore city, Maryland",4832,666,562,283,500,104,810,588,314,360,222,918,875,809,214,43,1232,1186,1094,92,46,1206,1206,1131,110,0
1400000US24510270402,"Census Tract 2704.02, Baltimore city, Maryland",3105,329,272,132,263,57,648,562,451,224,86,510,457,446,39,53,589,500,390,215,89,1029,968,939,115,61
1400000US24510270501,"Census Tract 2705.01, Baltimore city, Maryland",4430,501,463,307,269,38,505,484,336,273,21,1267,1219,1039,305,48,1008,949,905,129,59,1149,1117,1108,68,32
1400000US24510270502,"Census Tract 2705.02, Baltimore city, Maryland",4276,386,253,107,201,133,827,698,537,267,129,1043,946,863,252,97,969,947,867,115,22,1051,976,976,27,75
1400000US24510270600,"Census Tract 2706, Baltimore city, Maryland",4163,441,367,146,315,74,1053,909,499,527,144,918,808,760,212,110,396,374,321,90,22,1355,1260,1037,254,95
1400000US24510270701,"Census Tract 2707.01, Baltimore city, Maryland",2817,869,691,233,497,178,1189,1036,562,497,153,618,474,368,142,144,81,81,81,0,0,60,41,41,8,19
1400000US24510270702,"Census Tract 2707.02, Baltimore city, Maryland",2125,340,225,104,146,115,473,413,289,210,60,511,270,265,8,241,557,433,408,44,124,244,229,229,21,15
1400000US24510270703,"Census Tract 2707.03, Baltimore city, Maryland",2999,408,356,259,336,52,530,330,215,171,200,384,323,312,30,61,490,490,477,51,0,1187,1137,1126,82,50
1400000US24510270801,"Census Tract 2708.01, Baltimore city, Maryland",4651,640,632,112,616,8,1155,1054,771,549,101,1358,1062,804,321,296,851,767,598,183,84,647,595,563,87,52
1400000US24510270802,"Census Tract 2708.02, Baltimore city, Maryland",5318,1445,1207,256,1030,238,1539,1254,562,871,285,1603,1401,1037,569,202,200,165,165,16,35,531,531,531,9,0
1400000US24510270803,"Census Tract 2708.03, Baltimore city, Maryland",6115,1487,1220,821,637,267,1311,1044,726,470,267,1964,1809,1590,403,155,748,686,494,239,62,605,592,577,32,13
1400000US24510270804,"Census Tract 2708.04, Baltimore city, Maryland",3078,722,662,284,427,60,610,432,384,71,178,597,437,413,129,160,325,325,325,5,0,824,710,662,132,114
1400000US24510270805,"Census Tract 2708.05, Baltimore city, Maryland",4999,860,725,194,616,135,1353,1168,803,558,185,1367,1192,872,461,175,918,903,786,177,15,501,501,501,17,0
1400000US24510270901,"Census Tract 2709.01, Baltimore city, Maryland",4295,574,499,244,410,75,1167,952,562,571,215,1219,967,887,233,252,524,487,477,96,37,811,695,585,181,116
1400000US24510270902,"Census Tract 2709.02, Baltimore city, Maryland",3739,508,292,176,190,216,650,616,571,201,34,965,889,671,461,76,733,657,616,131,76,883,873,756,205,10
1400000US24510270903,"Census Tract 2709.03, Baltimore city, Maryland",3298,481,389,352,125,92,1112,1042,688,475,70,904,756,686,132,148,252,244,218,60,8,549,517,449,131,32
1400000US24510271001,"Census Tract 2710.01, Baltimore city, Maryland",2161,553,500,201,354,53,794,636,362,299,158,548,462,393,189,86,192,170,127,54,22,74,59,58,20,15
1400000US24510271002,"Census Tract 2710.02, Baltimore city, Maryland",4127,1352,1115,279,985,237,1353,1053,594,691,300,671,653,450,357,18,327,291,217,123,36,424,362,309,95,62
1400000US24510271101,"Census Tract 2711.01, Baltimore city, Maryland",1633,355,352,104,330,3,385,307,246,84,78,160,145,140,35,15,233,233,233,15,0,500,444,435,51,56
1400000US24510271102,"Census Tract 2711.02, Baltimore city, Maryland",1372,72,72,12,60,0,200,32,32,32,168,49,49,45,24,0,77,77,77,0,0,974,952,914,115,22
1400000US24510271200,"Census Tract 2712, Baltimore city, Maryland",5934,345,238,127,155,107,524,524,478,143,0,486,407,291,181,79,467,433,421,154,34,4112,4091,4066,297,21
1400000US24510271300,"Census Tract 2713, Baltimore city, Maryland",2740,230,203,143,60,27,140,140,119,29,0,210,185,168,17,25,300,289,274,64,11,1860,1860,1800,223,0
1400000US24510271400,"Census Tract 2714, Baltimore city, Maryland",3578,206,188,158,36,18,459,421,364,134,38,363,354,343,56,9,414,414,414,20,0,2136,2097,2080,251,39
1400000US24510271501,"Census Tract 2715.01, Baltimore city, Maryland",4130,370,236,209,61,134,256,256,248,84,0,476,436,431,117,40,434,417,345,115,17,2594,2524,2474,238,70
1400000US24510271503,"Census Tract 2715.03, Baltimore city, Maryland",819,50,50,32,23,0,109,99,72,55,10,106,106,102,60,0,168,168,168,0,0,386,386,357,217,0
1400000US24510271600,"Census Tract 2716, Baltimore city, Maryland",4868,1397,1158,249,1035,239,1436,1184,354,1022,252,957,840,510,348,117,653,509,353,166,144,425,396,390,24,29
1400000US24510271700,"Census Tract 2717, Baltimore city, Maryland",5094,1863,1481,660,1193,382,956,875,518,569,81,1197,1147,847,466,50,752,752,360,433,0,326,259,211,93,67
1400000US24510271801,"Census Tract 2718.01, Baltimore city, Maryland",3320,1242,1129,209,1104,113,689,603,329,359,86,267,228,185,83,39,402,370,353,17,32,720,690,528,201,30
1400000US24510271802,"Census Tract 2718.02, Baltimore city, Maryland",3201,979,821,95,782,158,1004,859,508,454,145,705,576,415,229,129,110,79,24,55,31,403,238,102,178,165
1400000US24510271900,"Census Tract 2719, Baltimore city, Maryland",3789,527,441,147,384,86,550,479,319,331,71,992,932,685,397,60,639,525,467,112,114,1081,1008,964,281,73
1400000US24510272003,"Census Tract 2720.03, Baltimore city, Maryland",5801,809,784,727,290,25,1052,902,682,452,150,668,668,645,114,0,860,785,771,96,75,2412,2205,2182,255,207
1400000US24510272004,"Census Tract 2720.04, Baltimore city, Maryland",4350,773,633,458,431,140,927,873,652,400,54,845,768,564,370,77,682,651,651,208,31,1123,819,757,245,304
1400000US24510272005,"Census Tract 2720.05, Baltimore city, Maryland",3096,433,412,268,247,21,605,517,384,299,88,595,595,405,319,0,548,526,510,93,22,915,915,887,88,0
1400000US24510272006,"Census Tract 2720.06, Baltimore city, Maryland",3748,1355,1295,264,1163,60,1321,1188,509,804,133,327,233,183,83,94,323,309,279,119,14,422,350,209,146,72
1400000US24510272007,"Census Tract 2720.07, Baltimore city, Maryland",4229,1228,925,156,862,303,1384,1174,992,285,210,671,623,503,263,48,354,270,243,50,84,592,546,520,149,46
1400000US24510280101,"Census Tract 2801.01, Baltimore city, Maryland",3627,822,669,135,648,153,1082,943,527,546,139,1048,916,661,378,132,454,395,307,156,59,221,221,212,9,0
1400000US24510280102,"Census Tract 2801.02, Baltimore city, Maryland",5732,1920,1524,573,1252,396,2154,1886,1326,1029,268,677,506,422,241,171,533,455,433,78,78,448,448,410,56,0
1400000US24510280200,"Census Tract 2802, Baltimore city, Maryland",5091,964,766,302,667,198,959,812,396,557,147,967,884,638,471,83,958,830,741,186,128,1243,1128,981,286,115
1400000US24510280301,"Census Tract 2803.01, Baltimore city, Maryland",4000,1139,999,238,893,140,1268,1045,681,423,223,865,700,468,296,165,254,211,102,156,43,474,474,467,44,0
1400000US24510280302,"Census Tract 2803.02, Baltimore city, Maryland",2229,810,622,177,535,188,370,339,234,186,31,292,241,195,132,51,335,329,193,150,6,422,377,288,133,45
1400000US24510280401,"Census Tract 2804.01, Baltimore city, Maryland",3520,609,507,156,437,102,819,761,655,274,58,964,905,658,413,59,489,478,465,60,11,639,632,629,46,7
1400000US24510280402,"Census Tract 2804.02, Baltimore city, Maryland",1859,357,294,129,254,63,506,479,328,241,27,475,347,197,175,128,276,271,235,59,5,245,202,167,80,43
1400000US24510280403,"Census Tract 2804.03, Baltimore city, Maryland",5390,714,590,215,484,124,1291,1081,647,498,210,924,823,720,151,101,541,479,457,42,62,1920,1792,1461,453,128
1400000US24510280404,"Census Tract 2804.04, Baltimore city, Maryland",2041,464,403,86,356,61,475,417,251,273,58,318,258,241,58,60,499,442,424,31,57,285,270,254,32,15
1400000US24510280500,"Census Tract 2805, Baltimore city, Maryland",1998,1545,1464,255,1318,81,205,186,125,72,19,47,47,37,10,0,158,158,135,158,0,43,43,43,17,0
1400000US24033806706,"Census Tract 8067.06, Prince George's County, Maryland",3094,234,142,124,83,92,464,344,307,146,120,446,353,342,68,93,687,605,535,194,82,1263,1190,1059,257,73
1400000US24033806708,"Census Tract 8067.08, Prince George's County, Maryland",4482,455,301,157,236,154,1646,1617,961,823,29,898,786,693,191,112,444,401,401,0,43,1039,1029,1013,82,10
1400000US24033806710,"Census Tract 8067.10, Prince George's County, Maryland",5675,254,99,81,18,155,1282,979,535,535,303,969,722,676,117,247,678,625,625,0,53,2492,2166,2128,137,326
1400000US24033806711,"Census Tract 8067.11, Prince George's County, Maryland",4610,185,114,87,30,71,1758,1204,874,367,554,702,472,341,157,230,547,477,263,246,70,1418,1167,1090,225,251
1400000US24033806712,"Census Tract 8067.12, Prince George's County, Maryland",3146,91,66,23,50,25,411,241,179,153,170,655,628,607,68,27,1075,576,488,182,499,914,822,796,59,92
1400000US24033806713,"Census Tract 8067.13, Prince George's County, Maryland",3598,525,411,76,335,114,1616,1134,778,376,482,742,553,442,111,189,139,101,39,62,38,576,549,549,0,27
1400000US24033806714,"Census Tract 8067.14, Prince George's County, Maryland",3230,451,308,243,65,143,653,387,281,106,266,1142,790,499,291,352,631,489,268,233,142,353,182,157,60,171
1400000US24033806800,"Census Tract 8068, Prince George's County, Maryland",3927,176,171,152,98,5,308,241,173,127,67,538,455,356,195,83,497,410,370,82,87,2408,2122,2059,216,286
1400000US24033806900,"Census Tract 8069, Prince George's County, Maryland",4014,179,161,99,127,18,528,494,458,135,34,777,735,663,153,42,850,725,585,188,125,1680,1488,1365,224,192
1400000US24033807000,"Census Tract 8070, Prince George's County, Maryland",5515,1463,1308,1074,323,155,944,621,596,72,323,565,484,454,94,81,1067,829,591,261,238,1476,1240,1065,267,236
1400000US24033807102,"Census Tract 8071.02, Prince George's County, Maryland",2578,271,235,225,20,36,535,416,152,280,119,563,497,480,95,66,370,280,280,38,90,839,759,729,87,80
1400000US24033807200,"Census Tract 8072, Prince George's County, Maryland",3606,2378,2288,2190,111,90,247,229,216,44,18,466,459,459,0,7,356,319,319,7,37,159,159,159,10,0
1400000US24033807301,"Census Tract 8073.01, Prince George's County, Maryland",3499,578,281,262,41,297,760,581,558,40,179,649,614,584,42,35,515,504,435,168,11,997,930,895,246,67
1400000US24033807304,"Census Tract 8073.04, Prince George's County, Maryland",2219,65,60,40,35,5,36,36,26,20,0,258,258,233,61,0,1018,681,479,249,337,842,732,709,132,110
1400000US24033807305,"Census Tract 8073.05, Prince George's County, Maryland",3549,54,23,16,23,31,704,527,393,174,177,831,643,625,63,188,513,310,259,103,203,1447,1085,1063,164,362
1400000US24033807404,"Census Tract 8074.04, Prince George's County, Maryland",4710,185,148,84,94,37,830,674,461,269,156,760,639,630,164,121,990,799,730,137,191,1945,1755,1727,217,190
1400000US24033807405,"Census Tract 8074.05, Prince George's County, Maryland",5563,566,546,449,128,20,324,281,116,217,43,1480,1266,1092,309,214,719,545,504,107,174,2474,2248,2015,434,226
1400000US24033807407,"Census Tract 8074.07, Prince George's County, Maryland",6261,248,197,164,97,51,690,590,445,173,100,911,783,698,118,128,779,583,487,239,196,3633,3287,3089,391,346
1400000US24033807408,"Census Tract 8074.08, Prince George's County, Maryland",5432,188,146,95,110,42,930,808,611,446,122,922,903,868,220,19,678,637,594,111,41,2714,2668,2632,214,46
1400000US24033807409,"Census Tract 8074.09, Prince George's County, Maryland",3761,550,457,300,360,93,1035,642,269,396,393,576,454,423,34,122,721,517,468,103,204,879,750,730,134,129
1400000US24033807410,"Census Tract 8074.10, Prince George's County, Maryland",3963,539,357,54,329,182,995,665,598,119,330,917,743,682,119,174,607,573,526,129,34,905,709,590,206,196
1400000US24035810100,"Census Tract 8101, Queen Anne's County, Maryland",2951,594,522,204,477,72,672,583,413,265,89,591,525,423,120,66,278,278,225,86,0,816,718,662,175,98
1400000US24035810200,"Census Tract 8102, Queen Anne's County, Maryland",2480,263,137,64,131,126,381,362,263,224,19,472,403,326,110,69,469,314,295,79,155,895,771,685,173,124
1400000US24035810300,"Census Tract 8103, Queen Anne's County, Maryland",4462,372,322,153,279,50,786,724,516,385,62,748,719,547,328,29,703,703,694,177,0,1853,1792,1765,69,61
1400000US24035810400,"Census Tract 8104, Queen Anne's County, Maryland",5844,379,362,173,304,17,410,410,295,222,0,1130,1081,887,296,49,1056,1040,1011,98,16,2869,2816,2768,284,53
1400000US24035810500,"Census Tract 8105, Queen Anne's County, Maryland",4252,581,540,361,456,41,452,450,409,212,2,701,646,587,172,55,452,452,431,87,0,2066,2047,1928,282,19
1400000US24035810600,"Census Tract 8106, Queen Anne's County, Maryland",4913,362,340,200,226,22,520,503,380,334,17,476,409,333,234,67,781,749,745,201,32,2774,2729,2629,369,45
1400000US24035810700,"Census Tract 8107, Queen Anne's County, Maryland",3883,417,353,168,237,64,330,307,267,166,23,598,547,448,155,51,802,698,550,249,104,1736,1714,1705,337,22
1400000US24035810800,"Census Tract 8108, Queen Anne's County, Maryland",5503,303,272,230,211,31,562,508,441,174,54,1135,1030,885,199,105,850,837,837,110,13,2653,2646,2635,221,7
1400000US24035810901,"Census Tract 8109.01, Queen Anne's County, Maryland",5110,66,33,13,33,33,504,292,215,145,212,686,657,539,234,29,666,627,627,160,39,3188,3163,3105,263,25
1400000US24035810902,"Census Tract 8109.02, Queen Anne's County, Maryland",3061,144,144,116,96,0,402,402,341,146,0,335,335,242,141,0,677,653,643,31,24,1503,1425,1327,263,78
1400000US24035811000,"Census Tract 8110, Queen Anne's County, Maryland",4736,339,327,179,223,12,546,436,254,298,110,1157,703,598,362,454,608,608,538,167,0,2086,1851,1819,210,235
1400000US24035990000,"Census Tract 9900, Queen Anne's County, Maryland",0,0,0,0,0,0,0,0,0,0,0,0,0,0,0,0,0,0,0,0,0,0,0,0,0,0
1400000US24035990100,"Census Tract 9901, Queen Anne's County, Maryland",0,0,0,0,0,0,0,0,0,0,0,0,0,0,0,0,0,0,0,0,0,0,0,0,0,0
1400000US24035990200,"Census Tract 9902, Queen Anne's County, Maryland",0,0,0,0,0,0,0,0,0,0,0,0,0,0,0,0,0,0,0,0,0,0,0,0,0,0
1400000US24037875000,"Census Tract 8750, St. Mary's County, Maryland",6401,149,137,77,85,12,517,501,484,120,16,944,879,879,231,65,1980,1919,1823,416,61,2811,2751,2659,188,60
1400000US24037875100,"Census Tract 8751, St. Mary's County, Maryland",4437,343,258,224,232,85,431,374,295,157,57,646,545,372,279,101,1025,970,798,272,55,1992,1821,1743,198,171
1400000US24037875201,"Census Tract 8752.01, St. Mary's County, Maryland",5042,228,205,85,177,23,1036,873,851,165,163,644,644,588,121,0,711,711,711,93,0,2423,2324,2271,115,99
1400000US24037875202,"Census Tract 8752.02, St. Mary's County, Maryland",6173,182,142,43,122,40,414,372,336,66,42,789,606,547,160,183,2000,1992,1949,321,8,2788,2627,2569,204,161
1400000US24037875300,"Census Tract 8753, St. Mary's County, Maryland",3333,425,356,173,307,69,401,377,254,243,24,520,415,381,102,105,706,677,492,285,29,1281,1270,1148,216,11
1400000US24037875400,"Census Tract 8754, St. Mary's County, Maryland",7023,810,766,340,531,44,585,567,459,244,18,1066,693,625,226,373,884,869,832,148,15,3678,3627,3504,424,51
1400000US24037875500,"Census Tract 8755, St. Mary's County, Maryland",7954,460,429,134,388,31,788,692,554,411,96,1400,720,589,290,680,1131,871,871,98,260,4175,3973,3855,294,202
1400000US24037875600,"Census Tract 8756, St. Mary's County, Maryland",8161,469,455,270,344,14,922,729,609,261,193,1231,1137,1069,294,94,1219,1100,992,278,119,4320,4063,4034,280,257
1400000US24037875700,"Census Tract 8757, St. Mary's County, Maryland",7065,308,195,124,183,113,558,532,481,221,26,1345,1071,895,330,274,824,769,754,209,55,4030,3876,3770,402,154
1400000US24037875801,"Census Tract 8758.01, St. Mary's County, Maryland",648,29,29,29,0,0,218,218,203,26,0,199,199,199,0,0,133,128,128,4,5,69,69,69,0,0
1400000US24037875802,"Census Tract 8758.02, St. Mary's County, Maryland",3692,77,60,45,26,17,340,194,174,59,146,588,502,447,89,86,644,644,644,156,0,2043,1988,1951,325,55
1400000US24037875901,"Census Tract 8759.01, St. Mary's County, Maryland",6714,857,672,328,414,185,822,718,514,293,104,808,780,780,83,28,1596,1382,1322,68,214,2631,2631,2625,150,0
1400000US24037875902,"Census Tract 8759.02, St. Mary's County, Maryland",7451,1226,1035,359,882,191,1250,1160,593,787,90,1632,1478,1077,542,154,1252,1113,894,289,139,2091,1936,1872,182,155
1400000US24037876001,"Census Tract 8760.01, St. Mary's County, Maryland",5479,1019,879,393,508,140,1551,1386,715,815,165,1113,1041,850,406,72,930,601,501,136,329,866,813,753,67,53
1400000US24037876002,"Census Tract 8760.02, St. Mary's County, Maryland",7977,999,938,364,678,61,940,845,763,224,95,1239,1181,922,432,58,1503,1329,1162,298,174,3296,3229,3229,149,67
1400000US24037876100,"Census Tract 8761, St. Mary's County, Maryland",7237,688,630,278,470,58,1128,730,542,377,398,475,440,397,149,35,723,687,656,85,36,4223,4084,4063,497,139
1400000US24037876200,"Census Tract 8762, St. Mary's County, Maryland",5692,637,620,174,608,17,474,462,347,290,12,907,865,677,384,42,1159,1126,1015,268,33,2515,2389,2389,332,126
1400000US24037990000,"Census Tract 9900, St. Mary's County, Maryland",0,0,0,0,0,0,0,0,0,0,0,0,0,0,0,0,0,0,0,0,0,0,0,0,0,0
1400000US24039930101,"Census Tract 9301.01, Somerset County, Maryland",4833,1932,1450,570,1011,482,1077,862,607,406,215,938,686,430,373,252,418,418,407,178,0,468,434,393,86,34
1400000US24039930102,"Census Tract 9301.02, Somerset County, Maryland",3455,494,368,222,275,126,748,669,504,377,79,967,878,777,271,89,581,560,479,159,21,665,656,626,41,9
1400000US24039930200,"Census Tract 9302, Somerset County, Maryland",1564,399,310,126,262,89,619,573,376,329,46,237,229,215,73,8,235,235,209,90,0,74,74,74,16,0
1400000US24039930300,"Census Tract 9303, Somerset County, Maryland",2520,291,257,185,195,34,669,594,384,360,75,864,759,655,163,105,170,170,155,30,0,526,502,487,66,24
1400000US24039930500,"Census Tract 9305, Somerset County, Maryland",3908,731,583,222,503,148,627,479,341,275,148,1214,1091,855,449,123,784,732,665,143,52,552,416,358,109,136
1400000US24039930600,"Census Tract 9306, Somerset County, Maryland",2893,1028,871,171,789,157,747,679,526,310,68,325,292,222,151,33,532,498,466,90,34,261,261,116,159,0
1400000US24039980400,"Census Tract 9804, Somerset County, Maryland",14,0,0,0,0,0,14,14,14,0,0,0,0,0,0,0,0,0,0,0,0,0,0,0,0,0
1400000US24039990100,"Census Tract 9901, Somerset County, Maryland",0,0,0,0,0,0,0,0,0,0,0,0,0,0,0,0,0,0,0,0,0,0,0,0,0,0
1400000US24041960100,"Census Tract 9601, Talbot County, Maryland",4453,640,576,353,321,64,938,777,452,545,161,946,825,820,153,121,643,620,573,147,23,1286,1217,1191,177,69
1400000US24041960201,"Census Tract 9602.01, Talbot County, Maryland",4043,453,363,178,287,90,593,593,420,419,0,512,483,472,191,29,405,405,381,234,0,2080,2068,2026,512,12
1400000US24041960300,"Census Tract 9603, Talbot County, Maryland",3353,735,564,138,463,171,854,658,346,430,196,703,606,453,273,97,500,456,407,119,44,561,479,445,63,82
1400000US24041960400,"Census Tract 9604, Talbot County, Maryland",5125,581,551,293,468,30,1841,1159,667,590,682,882,825,751,247,57,777,667,631,153,110,1044,956,943,182,88
1400000US24041960501,"Census Tract 9605.01, Talbot County, Maryland",4718,375,340,187,243,35,533,466,432,168,67,640,528,463,158,112,868,836,684,365,32,2302,1985,1985,145,317
1400000US24041960502,"Census Tract 9605.02, Talbot County, Maryland",4072,285,265,161,188,20,222,209,199,82,13,1175,1081,947,552,94,1165,935,912,193,230,1225,1115,1098,265,110
1400000US24041960600,"Census Tract 9606, Talbot County, Maryland",1791,249,196,141,155,53,249,220,167,123,29,324,297,244,87,27,344,344,330,105,0,625,599,561,201,26
1400000US24041960700,"Census Tract 9607, Talbot County, Maryland",3450,645,613,399,390,32,729,656,405,464,73,713,548,482,261,165,424,399,375,182,25,939,933,916,374,6
1400000US24041960800,"Census Tract 9608, Talbot County, Maryland",1992,211,149,135,97,62,493,376,348,287,117,409,374,357,153,35,232,181,168,65,51,647,547,516,267,100
1400000US24041960900,"Census Tract 9609, Talbot County, Maryland",4194,580,411,212,327,169,749,636,514,278,113,901,816,731,323,85,430,402,366,113,28,1534,1501,1484,216,33
1400000US24041990000,"Census Tract 9900, Talbot County, Maryland",0,0,0,0,0,0,0,0,0,0,0,0,0,0,0,0,0,0,0,0,0,0,0,0,0,0
1400000US24043000100,"Census Tract 1, Washington County, Maryland",3065,274,199,66,199,75,524,314,255,124,210,879,734,630,235,145,544,526,526,100,18,844,798,740,113,46
1400000US24043000200,"Census Tract 2, Washington County, Maryland",3666,356,267,193,162,89,809,687,563,292,122,1032,960,901,206,72,565,481,458,36,84,904,899,889,166,5
1400000US24043000301,"Census Tract 3.01, Washington County, Maryland",3093,710,606,220,538,104,770,630,470,335,140,654,508,427,158,146,582,514,473,69,68,377,377,334,77,0
1400000US24043000302,"Census Tract 3.02, Washington County, Maryland",3183,1464,1203,156,1183,261,724,594,446,235,130,739,705,508,254,34,155,142,119,24,13,101,72,48,24,29
1400000US24043000400,"Census Tract 4, Washington County, Maryland",1873,1112,1005,195,892,107,490,411,196,323,79,99,99,77,35,0,91,91,91,11,0,81,81,53,40,0
1400000US24043000500,"Census Tract 5, Washington County, Maryland",5599,1457,1210,391,936,247,2076,1485,1088,547,591,481,423,364,88,58,995,956,922,117,39,590,563,549,29,27
1400000US24043000601,"Census Tract 6.01, Washington County, Maryland",2493,449,403,172,288,46,837,603,353,341,234,282,198,123,85,84,651,651,573,78,0,274,274,244,30,0
1400000US24043000602,"Census Tract 6.02, Washington County, Maryland",2906,692,682,377,528,10,863,786,653,411,77,829,687,610,266,142,210,194,194,53,16,312,312,296,34,0
1400000US24043000700,"Census Tract 7, Washington County, Maryland",2985,1414,1126,399,855,288,670,565,382,306,105,587,442,256,216,145,84,74,74,10,10,230,188,164,66,42
1400000US24043000800,"Census Tract 8, Washington County, Maryland",3612,1073,943,185,834,130,862,798,620,312,64,779,632,516,153,147,609,543,436,172,66,289,277,266,20,12
1400000US24043000900,"Census Tract 9, Washington County, Maryland",3501,1237,1205,210,1107,32,994,796,432,443,198,627,577,505,108,50,251,190,160,50,61,392,352,352,43,40
1400000US24043001001,"Census Tract 10.01, Washington County, Maryland",5133,1443,1400,430,1181,43,1445,1199,768,697,246,916,902,802,286,14,416,416,296,137,0,913,913,817,212,0
1400000US24043001002,"Census Tract 10.02, Washington County, Maryland",4140,485,457,173,439,28,728,651,394,444,77,1063,963,817,250,100,754,666,599,124,88,1110,1110,1098,97,0
1400000US24043010100,"Census Tract 101, Washington County, Maryland",1231,444,405,117,405,39,150,112,51,78,38,255,221,185,77,34,218,213,209,15,5,164,164,164,0,0
1400000US24043010200,"Census Tract 102, Washington County, Maryland",4641,518,300,121,277,218,461,385,293,284,76,925,803,675,280,122,1096,1013,991,98,83,1641,1320,1294,179,321
1400000US24043010300,"Census Tract 103, Washington County, Maryland",7604,718,477,180,444,241,1373,1182,965,509,191,1764,1578,1478,565,186,894,757,684,232,137,2855,2729,2691,419,126
1400000US24043010400,"Census Tract 104, Washington County, Maryland",7785,763,680,346,532,83,1537,1367,1104,562,170,1624,1501,1359,234,123,1493,1403,1385,77,90,2368,2116,2034,264,252
1400000US24043010500,"Census Tract 105, Washington County, Maryland",6053,499,458,249,319,41,1674,1447,1132,753,227,1234,1209,811,607,25,942,899,834,81,43,1704,1638,1588,50,66
1400000US24043010600,"Census Tract 106, Washington County, Maryland",5068,338,285,19,285,53,1316,1151,966,442,165,1027,859,782,352,168,1164,1084,994,155,80,1223,1067,1054,70,156
1400000US24043010700,"Census Tract 107, Washington County, Maryland",3684,533,431,226,343,102,953,883,562,539,70,765,727,681,112,38,775,775,772,32,0,658,570,458,117,88
1400000US24043010801,"Census Tract 108.01, Washington County, Maryland",3992,307,284,157,258,23,993,914,642,578,79,807,764,685,315,43,823,767,682,150,56,1062,1036,1023,99,26
1400000US24043010802,"Census Tract 108.02, Washington County, Maryland",2348,509,497,235,419,12,526,467,405,235,59,613,530,451,135,83,258,247,247,39,11,442,419,377,70,23
1400000US24043010900,"Census Tract 109, Washington County, Maryland",8356,551,461,225,364,90,1574,1344,982,558,230,1496,1444,1363,233,52,1702,1615,1450,406,87,3033,2889,2707,438,144
1400000US24043011000,"Census Tract 110, Washington County, Maryland",0,0,0,0,0,0,0,0,0,0,0,0,0,0,0,0,0,0,0,0,0,0,0,0,0,0
1400000US24043011100,"Census Tract 111, Washington County, Maryland",5723,923,668,229,552,255,1494,1325,1004,695,169,1081,990,678,456,91,1034,843,765,196,191,1191,1172,1149,100,19
1400000US24043011201,"Census Tract 112.01, Washington County, Maryland",9080,1070,929,616,539,141,1509,1244,1004,606,265,2154,2048,1672,550,106,1552,1394,1136,407,158,2795,2729,2585,499,66
1400000US24043011202,"Census Tract 112.02, Washington County, Maryland",4315,420,339,252,186,81,847,735,471,415,112,1175,1093,798,464,82,625,606,533,151,19,1248,1100,1100,55,148
1400000US24043011301,"Census Tract 113.01, Washington County, Maryland",5021,357,314,217,229,43,960,848,577,416,112,860,832,791,267,28,874,848,766,157,26,1970,1883,1851,104,87
1400000US24043011302,"Census Tract 113.02, Washington County, Maryland",3903,268,215,140,131,53,342,307,211,156,35,931,807,579,284,124,566,550,459,126,16,1796,1796,1775,223,0
1400000US24043011400,"Census Tract 114, Washington County, Maryland",5414,414,358,153,327,56,1156,993,790,364,163,731,695,655,179,36,834,801,766,102,33,2279,2250,2198,176,29
1400000US24043011500,"Census Tract 115, Washington County, Maryland",7917,740,641,263,523,99,1206,926,606,658,280,1589,1468,1366,167,121,979,865,813,113,114,3403,3350,3252,296,53
1400000US24043011600,"Census Tract 116, Washington County, Maryland",2790,259,248,109,175,11,456,340,234,236,116,722,605,477,164,117,591,591,574,59,0,762,723,699,79,39
1400000US24045000100,"Census Tract 1, Wicomico County, Maryland",5898,1473,770,210,629,703,2268,1761,932,1002,507,1073,873,510,467,200,918,534,398,193,384,166,143,143,10,23
1400000US24045000200,"Census Tract 2, Wicomico County, Maryland",2110,354,253,82,177,101,828,611,367,294,217,227,204,175,71,23,438,422,383,44,16,263,263,225,84,0
1400000US24045000300,"Census Tract 3, Wicomico County, Maryland",1650,762,619,84,559,143,529,470,243,328,59,282,113,73,54,169,8,8,8,0,0,69,50,38,12,19
1400000US24045000400,"Census Tract 4, Wicomico County, Maryland",4189,1170,992,600,455,178,1088,913,542,474,175,677,560,493,225,117,529,529,521,59,0,725,645,554,158,80
1400000US24045000500,"Census Tract 5, Wicomico County, Maryland",2162,596,557,130,487,39,655,546,305,342,109,530,518,353,216,12,216,216,216,0,0,165,165,165,0,0
1400000US24045010101,"Census Tract 101.01, Wicomico County, Maryland",5783,750,622,406,390,128,1287,1094,649,643,193,1416,1288,1094,419,128,1136,861,723,182,275,1194,1124,1108,169,70
1400000US24045010102,"Census Tract 101.02, Wicomico County, Maryland",2594,451,365,267,230,86,783,681,469,378,102,470,470,426,160,0,421,396,363,122,25,469,409,409,50,60
1400000US24045010200,"Census Tract 102, Wicomico County, Maryland",6620,2391,2094,457,1828,297,1469,1117,819,571,352,1076,875,806,79,201,379,379,313,109,0,1305,952,577,517,353
1400000US24045010300,"Census Tract 103, Wicomico County, Maryland",8274,809,733,275,661,76,837,793,512,486,44,1544,1383,1142,473,161,1150,1127,1086,87,23,3934,3819,3762,291,115
1400000US24045010400,"Census Tract 104, Wicomico County, Maryland",4882,979,703,353,612,276,1057,1035,852,405,22,822,754,718,152,68,405,354,310,129,51,1619,1573,1523,350,46
1400000US24045010501,"Census Tract 105.01, Wicomico County, Maryland",4719,742,648,156,600,94,860,705,510,423,155,1329,1154,981,230,175,934,793,697,175,141,854,708,708,51,146
1400000US24045010502,"Census Tract 105.02, Wicomico County, Maryland",7480,2357,1942,1694,449,415,2388,2217,1868,557,171,1446,1198,1037,358,248,691,691,671,104,0,598,403,388,76,195
1400000US24045010603,"Census Tract 106.03, Wicomico County, Maryland",7411,648,479,143,409,169,1772,1542,1117,815,230,2300,2009,1403,904,291,1162,1082,791,382,80,1529,1377,1362,133,152
1400000US24045010604,"Census Tract 106.04, Wicomico County, Maryland",5092,749,579,155,528,170,1490,1159,692,698,331,842,784,575,253,58,983,923,867,100,60,1028,944,893,83,84
1400000US24045010605,"Census Tract 106.05, Wicomico County, Maryland",4250,334,253,54,224,81,551,505,377,234,46,637,545,477,181,92,358,358,358,58,0,2370,2231,2195,159,139
1400000US24045010606,"Census Tract 106.06, Wicomico County, Maryland",3729,247,219,73,168,28,962,845,733,279,117,910,898,778,205,12,883,834,783,107,49,727,656,656,58,71
1400000US24045010701,"Census Tract 107.01, Wicomico County, Maryland",4106,429,398,175,318,31,1096,949,524,520,147,913,809,760,138,104,477,459,440,64,18,1191,1155,1029,210,36
1400000US24045010702,"Census Tract 107.02, Wicomico County, Maryland",8129,1670,1323,318,1131,347,1481,1240,736,671,241,1815,1636,1439,391,179,1199,1092,949,377,107,1964,1809,1681,268,155
1400000US24045010800,"Census Tract 108, Wicomico County, Maryland",5801,833,482,195,438,351,859,735,563,444,124,1458,1425,1212,430,33,580,580,537,68,0,2071,1949,1879,292,122
1400000US24047950000,"Census Tract 9500, Worcester County, Maryland",1575,217,165,107,111,52,386,350,298,274,36,226,226,208,64,0,35,35,35,18,0,711,711,698,74,0
1400000US24047950100,"Census Tract 9501, Worcester County, Maryland",2257,426,342,257,182,84,222,204,133,163,18,394,376,352,195,18,194,142,126,33,52,1021,1021,1015,143,0
1400000US24047950300,"Census Tract 9503, Worcester County, Maryland",3255,612,510,378,264,102,1036,870,764,600,166,769,699,657,314,70,211,211,208,117,0,627,627,606,106,0
1400000US24047950400,"Census Tract 9504, Worcester County, Maryland",3069,82,69,49,34,13,683,585,224,471,98,669,610,331,391,59,662,634,601,147,28,973,947,927,150,26
1400000US24047950600,"Census Tract 9506, Worcester County, Maryland",2848,231,231,102,153,0,744,647,498,420,97,655,621,534,384,34,357,310,302,166,47,861,814,800,217,47
1400000US24047950700,"Census Tract 9507, Worcester County, Maryland",2013,181,138,131,109,43,172,172,123,116,0,373,237,237,115,136,361,263,224,144,98,926,885,817,185,41
1400000US24047950800,"Census Tract 9508, Worcester County, Maryland",5799,501,501,278,414,0,1215,1133,547,724,82,1431,1341,1038,539,90,769,769,760,153,0,1883,1835,1719,282,48
1400000US24047950900,"Census Tract 9509, Worcester County, Maryland",1880,265,217,135,168,48,768,647,371,380,121,418,358,335,58,60,287,223,172,102,64,142,142,142,30,0
1400000US24047951000,"Census Tract 9510, Worcester County, Maryland",4130,617,500,263,410,117,840,576,407,282,264,989,638,599,151,351,685,579,543,136,106,999,841,725,237,158
1400000US24047951100,"Census Tract 9511, Worcester County, Maryland",5878,549,362,208,277,187,848,819,589,633,29,1109,1086,1007,712,23,1375,1343,1223,550,32,1997,1889,1798,464,108
1400000US24047951200,"Census Tract 9512, Worcester County, Maryland",3675,400,307,101,259,93,1194,1004,601,568,190,556,474,459,135,82,472,457,426,45,15,1053,991,892,169,62
1400000US24047951300,"Census Tract 9513, Worcester County, Maryland",2617,787,724,295,525,63,527,496,355,340,31,464,454,415,66,10,302,247,162,131,55,537,505,460,121,32
1400000US24047951400,"Census Tract 9514, Worcester County, Maryland",3443,309,235,88,209,74,876,748,403,483,128,751,613,497,178,138,597,579,534,120,18,910,886,815,174,24
1400000US24047951500,"Census Tract 9515, Worcester County, Maryland",5081,1576,1279,385,1128,297,1256,1178,633,743,78,1224,1000,890,246,224,560,518,406,155,42,465,420,420,36,45
1400000US24047951700,"Census Tract 9517, Worcester County, Maryland",3082,460,250,201,167,210,524,448,390,182,76,740,685,625,348,55,390,376,326,137,14,968,959,934,152,9
1400000US24047980000,"Census Tract 9800, Worcester County, Maryland",0,0,0,0,0,0,0,0,0,0,0,0,0,0,0,0,0,0,0,0,0,0,0,0,0,0
1400000US24047990000,"Census Tract 9900, Worcester County, Maryland",0,0,0,0,0,0,0,0,0,0,0,0,0,0,0,0,0,0,0,0,0,0,0,0,0,0
1400000US24510010100,"Census Tract 101, Baltimore city, Maryland",2801,247,247,150,166,0,530,358,229,186,172,259,231,231,43,28,413,395,395,27,18,1352,1352,1352,85,0
1400000US24510010200,"Census Tract 102, Baltimore city, Maryland",3533,318,289,116,215,29,1040,595,303,400,445,478,440,378,80,38,587,438,438,0,149,1110,957,925,89,153
1400000US24510010300,"Census Tract 103, Baltimore city, Maryland",2226,118,110,89,64,8,199,156,129,71,43,447,374,336,48,73,366,315,301,14,51,1096,1090,1055,74,6
1400000US24510010400,"Census Tract 104, Baltimore city, Maryland",2025,115,115,90,55,0,417,363,307,133,54,292,288,288,35,4,209,209,209,0,0,992,949,949,66,43
1400000US24510010500,"Census Tract 105, Baltimore city, Maryland",1979,263,133,58,92,130,61,61,43,23,0,233,211,168,43,22,166,166,148,59,0,1256,1238,1226,111,18
1400000US24510020100,"Census Tract 201, Baltimore city, Maryland",2261,435,175,118,92,260,566,366,164,221,200,132,126,126,25,6,378,366,344,22,12,750,656,645,84,94
1400000US24510020200,"Census Tract 202, Baltimore city, Maryland",2002,220,166,93,99,54,389,334,226,126,55,365,342,312,42,23,469,293,243,50,176,559,377,377,0,182
1400000US24510020300,"Census Tract 203, Baltimore city, Maryland",3514,627,616,566,187,11,225,198,180,90,27,981,901,814,99,80,354,354,354,0,0,1327,1271,1229,82,56
1400000US24510030100,"Census Tract 301, Baltimore city, Maryland",2374,1510,1334,197,1244,176,557,323,217,134,234,175,175,111,71,0,45,45,45,0,0,87,87,87,0,0
1400000US24510030200,"Census Tract 302, Baltimore city, Maryland",2097,628,540,163,489,88,307,304,222,133,3,134,134,134,15,0,131,122,109,38,9,897,862,835,94,35
1400000US24510040100,"Census Tract 401, Baltimore city, Maryland",3215,807,807,748,59,0,783,754,732,84,29,722,675,675,0,47,349,349,349,0,0,554,554,530,24,0
1400000US24510040200,"Census Tract 402, Baltimore city, Maryland",739,497,427,403,42,70,146,95,86,9,51,74,74,74,0,0,22,22,22,0,0,0,0,0,0,0
1400000US24510060100,"Census Tract 601, Baltimore city, Maryland",3093,786,551,116,462,235,588,399,163,262,189,430,368,212,197,62,636,384,201,230,252,653,457,457,11,196
1400000US24510060200,"Census Tract 602, Baltimore city, Maryland",3160,1116,922,97,867,194,702,430,168,318,272,483,417,249,184,66,376,152,152,42,224,483,468,397,79,15
1400000US24510060300,"Census Tract 603, Baltimore city, Maryland",1729,534,501,70,463,33,223,150,112,38,73,298,272,196,81,26,312,300,300,34,12,362,354,334,27,8
1400000US24510060400,"Census Tract 604, Baltimore city, Maryland",1459,450,420,242,264,30,480,236,59,196,244,23,23,23,0,0,176,176,176,0,0,330,330,330,0,0
1400000US24510070100,"Census Tract 701, Baltimore city, Maryland",3259,915,817,57,780,98,960,854,349,590,106,833,820,159,750,13,337,337,205,165,0,214,106,49,72,108
1400000US24510070200,"Census Tract 702, Baltimore city, Maryland",3854,1774,1455,208,1302,319,968,731,297,552,237,873,785,422,478,88,16,16,16,7,0,223,92,84,26,131
1400000US24510070300,"Census Tract 703, Baltimore city, Maryland",1132,658,603,47,580,55,258,253,111,151,5,35,35,35,0,0,53,53,53,20,0,128,128,87,76,0
1400000US24510070400,"Census Tract 704, Baltimore city, Maryland",1218,569,515,157,410,54,227,221,79,199,6,111,111,10,101,0,287,201,86,125,86,24,24,16,8,0
1400000US24510080101,"Census Tract 801.01, Baltimore city, Maryland",3352,681,597,172,466,84,469,400,269,192,69,694,481,372,130,213,397,371,358,22,26,1111,1013,743,274,98
1400000US24510080102,"Census Tract 801.02, Baltimore city, Maryland",2445,488,399,94,344,89,853,731,311,465,122,541,426,222,238,115,121,109,68,60,12,442,326,198,141,116
1400000US24510080200,"Census Tract 802, Baltimore city, Maryland",1260,546,512,94,487,34,210,210,109,155,0,337,297,199,132,40,126,99,99,6,27,41,41,41,17,0
1400000US24510080301,"Census Tract 803.01, Baltimore city, Maryland",1700,509,482,138,475,27,581,568,314,308,13,363,306,182,133,57,205,144,102,79,61,42,42,38,7,0
1400000US24510080302,"Census Tract 803.02, Baltimore city, Maryland",2942,1316,1169,357,1043,147,795,680,276,560,115,613,570,397,265,43,0,0,0,0,0,218,218,202,38,0
1400000US24510080400,"Census Tract 804, Baltimore city, Maryland",1289,675,625,60,600,50,313,268,188,143,45,90,59,20,39,31,211,95,34,61,116,0,0,0,0,0
1400000US24510080500,"Census Tract 805, Baltimore city, Maryland",1592,554,417,159,326,137,482,442,180,326,40,426,302,172,202,124,112,112,86,26,0,18,18,18,2,0
1400000US24510080600,"Census Tract 806, Baltimore city, Maryland",2266,633,543,158,486,90,883,658,405,279,225,508,490,434,115,18,219,219,66,178,0,23,19,11,10,4
1400000US24510080700,"Census Tract 807, Baltimore city, Maryland",867,524,461,176,368,63,183,127,57,98,56,99,50,14,36,49,0,0,0,0,0,61,40,12,28,21
1400000US24510080800,"Census Tract 808, Baltimore city, Maryland",990,385,385,26,385,0,225,192,146,99,33,299,177,117,129,122,65,55,43,27,10,16,12,10,6,4
1400000US24510090100,"Census Tract 901, Baltimore city, Maryland",4671,1066,961,318,847,105,1011,845,508,475,166,1466,1158,750,537,308,679,567,462,227,112,449,433,338,176,16
1400000US24510090200,"Census Tract 902, Baltimore city, Maryland",3471,490,432,188,330,58,683,557,475,318,126,419,419,395,175,0,1124,989,860,244,135,755,703,638,298,52
1400000US24510090300,"Census Tract 903, Baltimore city, Maryland",4132,1243,1000,229,930,243,583,477,265,256,106,604,565,460,217,39,792,651,621,122,141,910,812,777,59,98
1400000US24510090400,"Census Tract 904, Baltimore city, Maryland",1394,613,578,154,483,35,401,314,196,141,87,230,198,152,46,32,104,76,76,0,28,46,46,46,0,0
1400000US24510090500,"Census Tract 905, Baltimore city, Maryland",2172,770,679,188,614,91,711,540,226,410,171,307,193,117,91,114,22,22,22,5,0,362,263,263,15,99
1400000US24510090600,"Census Tract 906, Baltimore city, Maryland",3202,713,573,256,442,140,898,668,397,300,230,917,809,615,360,108,471,391,183,254,80,203,198,149,95,5
1400000US24510090700,"Census Tract 907, Baltimore city, Maryland",3648,1071,988,205,880,83,1425,1044,597,560,381,645,634,392,335,11,74,74,37,39,0,433,406,338,88,27
1400000US24510090800,"Census Tract 908, Baltimore city, Maryland",3661,1302,1028,331,903,274,980,831,453,488,149,877,814,600,325,63,285,230,175,68,55,217,185,154,59,32
1400000US24510090900,"Census Tract 909, Baltimore city, Maryland",2427,1084,1025,132,972,59,407,278,216,111,129,365,292,139,161,73,281,242,111,143,39,290,247,49,198,43
1400000US24510100100,"Census Tract 1001, Baltimore city, Maryland",2239,677,541,143,469,136,878,706,380,378,172,379,361,209,206,18,133,133,118,25,0,172,131,115,16,41
1400000US24510100200,"Census Tract 1002, Baltimore city, Maryland",3009,2228,2110,295,2017,118,316,266,113,179,50,91,91,91,7,0,164,141,125,22,23,210,163,117,110,47
1400000US24510100300,"Census Tract 1003, Baltimore city, Maryland",0,0,0,0,0,0,0,0,0,0,0,0,0,0,0,0,0,0,0,0,0,0,0,0,0,0
1400000US24031700903,"Census Tract 7009.03, Montgomery County, Maryland",1851,247,221,69,205,26,367,275,200,151,92,263,245,245,4,18,446,401,384,22,45,528,503,446,127,25
1400000US24031700904,"Census Tract 7009.04, Montgomery County, Maryland",2854,238,188,85,153,50,469,278,194,113,191,789,587,503,125,202,586,540,540,6,46,772,755,755,59,17
1400000US24031700905,"Census Tract 7009.05, Montgomery County, Maryland",3959,156,156,115,116,0,410,410,350,247,0,787,683,674,44,104,700,669,647,105,31,1906,1854,1783,167,52
1400000US24031701001,"Census Tract 7010.01, Montgomery County, Maryland",5190,335,289,46,255,46,662,489,306,355,173,461,408,358,166,53,812,780,681,185,32,2920,2748,2706,321,172
1400000US24031701002,"Census Tract 7010.02, Montgomery County, Maryland",3677,5,5,5,5,0,117,117,117,41,0,70,70,70,28,0,72,72,66,27,0,3413,3378,3268,557,35
1400000US24031701004,"Census Tract 7010.04, Montgomery County, Maryland",4986,425,365,242,200,60,468,400,356,105,68,514,387,357,152,127,486,441,434,125,45,3093,3052,2983,381,41
1400000US24031701005,"Census Tract 7010.05, Montgomery County, Maryland",3252,61,61,29,32,0,265,205,136,113,60,106,106,92,39,0,592,544,544,66,48,2228,2175,2163,101,53
1400000US24031701006,"Census Tract 7010.06, Montgomery County, Maryland",5199,202,183,183,125,19,310,310,310,146,0,295,236,217,157,59,550,494,433,233,56,3842,3741,3628,440,101
1400000US24031701007,"Census Tract 7010.07, Montgomery County, Maryland",3202,12,0,0,0,12,367,317,289,100,50,442,388,371,82,54,498,454,454,23,44,1883,1871,1847,101,12
1400000US24031701101,"Census Tract 7011.01, Montgomery County, Maryland",4400,309,264,155,129,45,284,233,194,123,51,565,354,314,100,211,1023,742,620,172,281,2219,2161,2059,312,58
1400000US24031701102,"Census Tract 7011.02, Montgomery County, Maryland",6335,350,288,67,241,62,579,416,350,202,163,1427,1260,1077,296,167,1266,1122,993,177,144,2713,2292,2249,254,421
1400000US24031701201,"Census Tract 7012.01, Montgomery County, Maryland",5348,258,258,38,244,0,1108,911,843,276,197,915,777,677,263,138,806,765,765,66,41,2261,1976,1886,163,285
1400000US24031701202,"Census Tract 7012.02, Montgomery County, Maryland",2678,140,122,122,24,18,115,110,82,80,5,155,155,124,121,0,196,194,194,6,2,2072,2012,1977,197,60
1400000US24031701205,"Census Tract 7012.05, Montgomery County, Maryland",6307,316,203,177,79,113,268,231,200,57,37,310,300,269,117,10,418,402,376,157,16,4995,4820,4755,678,175
1400000US24031701206,"Census Tract 7012.06, Montgomery County, Maryland",6493,167,99,90,43,68,305,274,197,152,31,667,498,430,123,169,448,448,393,172,0,4906,4833,4749,595,73
1400000US24031701210,"Census Tract 7012.10, Montgomery County, Maryland",4020,65,37,29,37,28,245,245,235,86,0,255,255,233,96,0,157,129,129,68,28,3298,3180,3080,464,118
1400000US24031701211,"Census Tract 7012.11, Montgomery County, Maryland",5995,328,309,113,254,19,564,390,267,149,174,757,722,694,91,35,498,466,449,97,32,3848,3625,3563,250,223
1400000US24031701212,"Census Tract 7012.12, Montgomery County, Maryland",2644,50,50,50,10,0,122,122,117,73,0,149,127,89,48,22,172,172,172,37,0,2151,2095,2025,379,56
1400000US24031701213,"Census Tract 7012.13, Montgomery County, Maryland",5898,378,307,152,209,71,396,384,330,165,12,547,522,485,104,25,530,520,520,14,10,4047,4021,3913,500,26
1400000US24031701214,"Census Tract 7012.14, Montgomery County, Maryland",2573,264,209,188,41,55,424,285,226,114,139,270,252,252,14,18,431,431,431,35,0,1184,1174,1158,146,10
1400000US24031701215,"Census Tract 7012.15, Montgomery County, Maryland",4246,339,308,244,162,31,694,679,482,325,15,693,661,647,105,32,490,490,490,103,0,2030,2013,1932,279,17
1400000US24031701216,"Census Tract 7012.16, Montgomery County, Maryland",3955,267,240,133,163,27,754,650,529,246,104,457,400,400,41,57,381,345,328,47,36,2096,1986,1869,433,110
1400000US24031701218,"Census Tract 7012.18, Montgomery County, Maryland",2349,290,257,194,187,33,294,240,212,80,54,496,496,441,55,0,266,252,252,19,14,1003,949,943,55,54
1400000US24031701219,"Census Tract 7012.19, Montgomery County, Maryland",2922,308,156,12,149,152,582,419,316,126,163,509,452,411,41,57,610,480,459,57,130,913,848,813,87,65
1400000US24031701220,"Census Tract 7012.20, Montgomery County, Maryland",4264,106,106,106,38,0,255,207,168,94,48,134,134,134,27,0,471,471,471,36,0,3298,3170,3071,298,128
1400000US24031701221,"Census Tract 7012.21, Montgomery County, Maryland",4344,345,332,220,192,13,445,334,242,179,111,86,86,86,4,0,183,183,183,42,0,3285,3241,3189,98,44
1400000US24031701303,"Census Tract 7013.03, Montgomery County, Maryland",3777,106,97,87,51,9,94,71,36,71,23,334,323,305,162,11,385,385,332,113,0,2858,2732,2682,470,126
1400000US24031701304,"Census Tract 7013.04, Montgomery County, Maryland",6086,273,242,144,236,31,350,224,166,104,126,682,562,530,185,120,517,517,517,155,0,4264,4206,4205,420,58
1400000US24031701306,"Census Tract 7013.06, Montgomery County, Maryland",3029,0,0,0,0,0,169,103,103,63,66,199,170,170,82,29,109,109,109,18,0,2552,2474,2474,342,78
1400000US24031701307,"Census Tract 7013.07, Montgomery County, Maryland",3725,83,66,19,47,17,170,109,100,21,61,491,408,408,33,83,401,381,305,92,20,2580,2534,2475,225,46
1400000US24031701308,"Census Tract 7013.08, Montgomery County, Maryland",2916,213,201,89,119,12,153,153,99,86,0,182,182,163,82,0,115,109,109,33,6,2253,2060,2021,210,193
1400000US24031701312,"Census Tract 7013.12, Montgomery County, Maryland",6084,316,240,84,230,76,374,321,310,72,53,426,407,384,103,19,473,473,436,124,0,4495,4348,4222,353,147
1400000US24031701313,"Census Tract 7013.13, Montgomery County, Maryland",3643,109,0,0,0,109,239,239,239,52,0,554,426,349,88,128,700,689,684,63,11,2041,1987,1976,183,54
1400000US24031701314,"Census Tract 7013.14, Montgomery County, Maryland",2978,0,0,0,0,0,63,63,63,0,0,622,505,484,51,117,478,463,452,11,15,1815,1767,1727,117,48
1400000US24031701315,"Census Tract 7013.15, Montgomery County, Maryland",4659,71,71,34,71,0,370,340,279,146,30,618,574,536,78,44,567,470,470,29,97,3033,2714,2714,132,319
1400000US24031701316,"Census Tract 7013.16, Montgomery County, Maryland",5584,524,471,290,348,53,295,281,183,203,14,531,473,342,295,58,304,304,286,92,0,3930,3793,3763,487,137
1400000US24031701317,"Census Tract 7013.17, Montgomery County, Maryland",4235,24,24,12,24,0,117,81,81,0,36,296,267,267,73,29,222,222,222,50,0,3576,3550,3521,265,26
1400000US24031701407,"Census Tract 7014.07, Montgomery County, Maryland",5529,142,100,57,70,42,210,164,151,72,46,603,528,497,102,75,842,764,616,278,78,3732,3548,3339,507,184
1400000US24031701408,"Census Tract 7014.08, Montgomery County, Maryland",6395,134,122,111,11,12,452,211,146,65,241,486,445,399,164,41,746,650,607,131,96,4577,4430,4219,779,147
1400000US24031701409,"Census Tract 7014.09, Montgomery County, Maryland",4188,95,84,73,44,11,261,197,80,149,64,447,412,401,160,35,244,244,244,110,0,3141,3074,3000,376,67
1400000US24031701410,"Census Tract 7014.10, Montgomery County, Maryland",6925,506,447,217,331,59,858,689,443,263,169,1145,961,693,280,184,962,900,900,24,62,3454,3333,3295,231,121
1400000US24031701414,"Census Tract 7014.14, Montgomery County, Maryland",7074,723,464,394,185,259,920,832,510,477,88,1031,815,576,403,216,1337,1146,936,423,191,3063,2966,2826,374,97
1400000US24031701415,"Census Tract 7014.15, Montgomery County, Maryland",7534,429,411,343,68,18,902,608,412,331,294,1311,793,625,334,518,1202,1071,839,341,131,3690,3514,3395,478,176
1400000US24031701417,"Census Tract 7014.17, Montgomery County, Maryland",5867,1268,1133,438,750,135,845,787,742,105,58,1242,1158,996,174,84,902,902,804,98,0,1610,1248,1248,184,362
1400000US24031701418,"Census Tract 7014.18, Montgomery County, Maryland",3473,159,76,16,60,83,611,318,120,198,293,421,400,280,150,21,370,336,327,47,34,1912,1873,1856,94,39
1400000US24031701420,"Census Tract 7014.20, Montgomery County, Maryland",6583,627,541,346,541,86,1191,1070,857,830,121,1439,1173,981,935,266,872,800,642,456,72,2454,2266,2220,527,188
1400000US24031701421,"Census Tract 7014.21, Montgomery County, Maryland",1904,62,49,0,49,13,327,310,151,186,17,397,268,147,121,129,702,491,359,139,211,416,314,314,0,102
1400000US24031701422,"Census Tract 7014.22, Montgomery County, Maryland",2839,347,232,103,129,115,1476,1085,564,574,391,425,299,255,44,126,161,136,81,70,25,430,390,390,34,40
1400000US24031701423,"Census Tract 7014.23, Montgomery County, Maryland",4734,618,541,72,482,77,1039,748,391,390,291,1009,766,740,75,243,626,490,478,27,136,1442,1258,1191,115,184
1400000US24031701503,"Census Tract 7015.03, Montgomery County, Maryland",6926,207,176,127,90,31,417,417,352,286,0,955,781,507,384,174,1783,1504,1261,534,279,3564,3259,3003,529,305
1400000US24031701505,"Census Tract 7015.05, Montgomery County, Maryland",6908,1031,688,203,622,343,963,633,278,406,330,794,589,532,149,205,854,589,589,104,265,3266,2946,2890,175,320
1400000US24031701506,"Census Tract 7015.06, Montgomery County, Maryland",4966,127,115,32,105,12,542,484,204,331,58,424,399,264,241,25,436,426,406,121,10,3437,3106,3010,544,331
1400000US24031701507,"Census Tract 7015.07, Montgomery County, Maryland",4977,283,230,200,163,53,428,403,249,279,25,632,476,476,116,156,264,257,257,106,7,3370,3291,3136,430,79
1400000US24031701508,"Census Tract 7015.08, Montgomery County, Maryland",3785,614,595,154,517,19,879,578,390,240,301,847,754,716,45,93,663,579,458,137,84,782,596,578,38,186
1400000US24031701509,"Census Tract 7015.09, Montgomery County, Maryland",5440,962,702,258,602,260,1658,933,622,401,725,795,683,531,206,112,767,620,620,0,147,1258,1165,1129,304,93
1400000US24031701601,"Census Tract 7016.01, Montgomery County, Maryland",2158,108,96,63,43,12,650,377,177,237,273,852,643,511,148,209,338,288,124,168,50,210,203,194,28,7
1400000US24031701602,"Census Tract 7016.02, Montgomery County, Maryland",6801,505,275,148,215,230,937,653,421,276,284,1986,922,308,723,1064,1239,459,185,354,780,2134,1725,1606,193,409
1400000US24031701701,"Census Tract 7017.01, Montgomery County, Maryland",3074,304,254,167,172,50,612,454,388,195,158,254,248,248,10,6,322,322,322,6,0,1582,1565,1557,81,17
1400000US24031701702,"Census Tract 7017.02, Montgomery County, Maryland",2135,348,258,190,222,90,441,420,400,59,21,407,295,193,127,112,404,274,274,0,130,535,362,362,19,173
1400000US24031701703,"Census Tract 7017.03, Montgomery County, Maryland",3703,173,90,60,39,83,622,414,214,242,208,640,445,307,181,195,439,340,261,96,99,1829,1649,1597,156,180
1400000US24031701704,"Census Tract 7017.04, Montgomery County, Maryland",2812,225,171,51,162,54,496,348,282,126,148,421,409,398,21,12,227,227,211,61,0,1443,1371,1344,160,72
1400000US24031701800,"Census Tract 7018, Montgomery County, Maryland",4632,738,543,289,326,195,652,504,407,180,148,710,519,413,194,191,220,176,166,40,44,2312,2194,2174,129,118
1400000US24031701900,"Census Tract 7019, Montgomery County, Maryland",3196,605,214,68,146,391,889,459,312,175,430,366,291,215,87,75,445,436,436,20,9,891,460,314,177,431
1400000US24031702000,"Census Tract 7020, Montgomery County, Maryland",5425,1012,679,92,627,333,1694,1021,516,533,673,938,385,353,55,553,584,332,320,37,252,1197,901,774,223,296
1400000US24031702101,"Census Tract 7021.01, Montgomery County, Maryland",5577,977,429,101,336,548,1011,637,359,348,374,1021,849,614,284,172,1115,766,627,217,349,1453,1193,1036,264,260
1400000US24031702102,"Census Tract 7021.02, Montgomery County, Maryland",2844,64,35,8,27,29,132,122,89,93,10,272,272,260,63,0,87,87,87,42,0,2289,2224,2204,163,65
1400000US24031702200,"Census Tract 7022, Montgomery County, Maryland",4107,109,53,53,39,56,386,331,166,246,55,177,167,152,51,10,624,592,592,20,32,2811,2768,2712,218,43
1400000US24031702301,"Census Tract 7023.01, Montgomery County, Maryland",4328,412,342,87,313,70,1280,458,284,254,822,1255,975,478,541,280,586,416,262,161,170,795,695,670,61,100
1400000US24031702302,"Census Tract 7023.02, Montgomery County, Maryland",4342,170,130,60,89,40,1161,743,488,272,418,868,720,476,289,148,184,184,184,29,0,1959,1776,1715,267,183
1400000US24031702401,"Census Tract 7024.01, Montgomery County, Maryland",2481,104,44,44,5,60,192,137,80,62,55,207,139,117,71,68,224,203,194,61,21,1754,1704,1650,183,50
1400000US24031702402,"Census Tract 7024.02, Montgomery County, Maryland",4278,567,504,126,429,63,369,344,298,110,25,915,817,718,132,98,910,887,757,169,23,1517,1473,1431,86,44
1400000US24031702500,"Census Tract 7025, Montgomery County, Maryland",5175,740,688,366,390,52,1012,802,695,244,210,1050,640,535,105,410,742,616,616,0,126,1631,1608,1608,8,23
1400000US24031702601,"Census Tract 7026.01, Montgomery County, Maryland",4381,391,316,179,188,75,811,687,561,219,124,1167,1104,1104,16,63,960,928,897,138,32,1052,1011,1000,56,41
1400000US24031702602,"Census Tract 7026.02, Montgomery County, Maryland",4598,930,545,252,321,385,723,537,430,120,186,852,692,655,103,160,533,508,508,28,25,1560,1560,1494,157,0
1400000US24031702700,"Census Tract 7027, Montgomery County, Maryland",6445,674,395,234,219,279,1144,702,444,320,442,652,324,306,118,328,571,429,429,105,142,3404,3276,3220,184,128
1400000US24031702800,"Census Tract 7028, Montgomery County, Maryland",4576,341,317,225,151,24,464,392,392,36,72,485,461,415,143,24,560,538,522,48,22,2726,2659,2641,149,67
1400000US24031702900,"Census Tract 7029, Montgomery County, Maryland",5510,144,103,58,74,41,198,148,132,94,50,487,434,417,117,53,672,672,655,115,0,4009,3975,3896,339,34
1400000US24031703000,"Census Tract 7030, Montgomery County, Maryland",1780,83,59,59,45,24,56,56,56,9,0,377,357,357,10,20,271,218,173,92,53,993,953,931,97,40
1400000US24031703100,"Census Tract 7031, Montgomery County, Maryland",4259,137,101,81,69,36,474,333,228,252,141,335,284,262,54,51,907,772,703,157,135,2406,2054,1973,265,352
1400000US24031703201,"Census Tract 7032.01, Montgomery County, Maryland",7580,282,233,93,206,49,785,585,326,424,200,932,813,631,357,119,1243,1221,1186,143,22,4338,3618,3198,955,720
1400000US24031703202,"Census Tract 7032.02, Montgomery County, Maryland",5992,437,437,202,398,0,670,473,256,278,197,377,349,321,114,28,553,497,497,235,56,3955,3645,3455,548,310
1400000US24031703206,"Census Tract 7032.06, Montgomery County, Maryland",3848,323,136,73,88,187,512,413,206,250,99,625,620,611,191,5,531,480,461,81,51,1857,1631,1520,331,226
1400000US24031703207,"Census Tract 7032.07, Montgomery County, Maryland",5881,872,746,205,617,126,1484,778,304,520,706,1091,529,225,304,562,816,620,483,197,196,1618,1470,1413,225,148
1400000US24031703208,"Census Tract 7032.08, Montgomery County, Maryland",5089,164,102,78,62,62,250,227,173,116,23,502,451,442,148,51,640,586,562,106,54,3533,3466,3331,597,67
1400000US24031703209,"Census Tract 7032.09, Montgomery County, Maryland",5619,1018,720,118,670,298,1502,1242,423,945,260,973,849,755,230,124,575,452,407,121,123,1551,1385,1262,224,166
1400000US24031703210,"Census Tract 7032.10, Montgomery County, Maryland",3474,200,182,112,164,18,183,154,154,70,29,399,303,280,80,96,424,413,413,93,11,2268,1981,1929,147,287
1400000US24031703212,"Census Tract 7032.12, Montgomery County, Maryland",7804,479,396,75,338,83,550,386,263,159,164,1568,1173,847,475,395,667,646,611,198,21,4540,4062,3902,584,478
1400000US24031703213,"Census Tract 7032.13, Montgomery County, Maryland",5701,741,679,283,534,62,1892,1400,757,676,492,1334,931,762,187,403,774,614,591,52,160,960,815,769,120,145
1400000US24031703214,"Census Tract 7032.14, Montgomery County, Maryland",6753,2108,1563,402,1293,545,1099,784,508,309,315,1324,1138,659,513,186,1273,988,714,322,285,949,722,676,213,227
1400000US24031703215,"Census Tract 7032.15, Montgomery County, Maryland",3283,259,173,109,85,86,320,157,94,107,163,634,320,103,270,314,706,626,598,94,80,1364,1289,1224,223,75
1400000US24031703216,"Census Tract 7032.16, Montgomery County, Maryland",3520,338,317,231,261,21,832,832,802,516,0,577,522,451,384,55,300,300,282,166,0,1473,1330,973,596,143
1400000US24031703218,"Census Tract 7032.18, Montgomery County, Maryland",1737,269,269,242,260,0,468,468,403,428,0,381,381,332,329,0,191,191,166,171,0,428,428,395,348,0
1400000US24031703219,"Census Tract 7032.19, Montgomery County, Maryland",3423,584,551,272,524,33,647,647,609,577,0,591,591,501,549,0,486,468,445,468,18,1115,1115,1026,912,0
1400000US24031703220,"Census Tract 7032.20, Montgomery County, Maryland",4498,782,681,324,496,101,600,516,273,321,84,680,605,402,211,75,611,562,529,59,49,1825,1639,1613,335,186
1400000US24031703221,"Census Tract 7032.21, Montgomery County, Maryland",4630,484,382,109,300,102,370,319,267,156,51,727,592,509,150,135,303,263,225,59,40,2746,2487,2310,301,259
1400000US24031703301,"Census Tract 7033.01, Montgomery County, Maryland",4323,213,122,49,101,91,572,329,227,242,243,1238,848,704,317,390,814,616,570,116,198,1486,1047,918,192,439
1400000US24031703302,"Census Tract 7033.02, Montgomery County, Maryland",4417,194,74,34,54,120,608,455,427,102,153,894,605,309,396,289,1386,944,512,475,442,1335,962,906,199,373
1400000US24031703401,"Census Tract 7034.01, Montgomery County, Maryland",5285,130,98,73,40,32,784,609,387,263,175,1432,773,628,311,659,1451,1193,884,392,258,1488,1110,902,293,378
1400000US24031703402,"Census Tract 7034.02, Montgomery County, Maryland",3400,87,72,41,62,15,162,130,74,84,32,574,422,335,111,152,542,467,345,182,75,2035,1735,1654,231,300
1400000US24031703403,"Census Tract 7034.03, Montgomery County, Maryland",3579,169,107,31,99,62,575,321,180,185,254,982,766,519,343,216,475,336,241,154,139,1378,932,835,113,446
1400000US24031703404,"Census Tract 7034.04, Montgomery County, Maryland",2979,212,194,84,149,18,958,574,316,332,384,858,641,418,272,217,464,296,233,83,168,487,436,414,22,51
1400000US24031703501,"Census Tract 7035.01, Montgomery County, Maryland",6721,976,891,273,680,85,1258,790,322,560,468,1820,1029,805,299,791,818,518,395,226,300,1849,1271,1132,406,578
1400000US24031703502,"Census Tract 7035.02, Montgomery County, Maryland",3342,552,420,73,403,132,233,185,152,131,48,769,444,311,240,325,550,326,221,127,224,1238,1221,1188,114,17
1400000US24031703601,"Census Tract 7036.01, Montgomery County, Maryland",4596,224,205,77,195,19,790,569,387,274,221,872,610,380,352,262,539,484,472,78,55,2171,1957,1827,272,214
1400000US24031703602,"Census Tract 7036.02, Montgomery County, Maryland",2866,103,103,77,33,0,338,212,191,129,126,257,227,91,167,30,348,311,227,92,37,1820,1805,1797,134,15
1400000US24031703701,"Census Tract 7037.01, Montgomery County, Maryland",3937,189,94,20,84,95,749,537,302,315,212,832,567,459,119,265,816,616,463,196,200,1351,1016,950,217,335
1400000US24031703702,"Census Tract 7037.02, Montgomery County, Maryland",3871,90,61,39,45,29,362,200,146,77,162,1051,744,444,369,307,917,469,402,90,448,1451,1376,1303,186,75
1400000US24031703800,"Census Tract 7038, Montgomery County, Maryland",2871,274,231,140,124,43,648,432,212,263,216,564,334,229,175,230,457,395,378,27,62,928,906,863,58,22
1400000US24031703901,"Census Tract 7039.01, Montgomery County, Maryland",2986,117,81,52,41,36,397,391,386,21,6,440,383,369,53,57,297,274,245,61,23,1735,1685,1630,133,50
1400000US24031703902,"Census Tract 7039.02, Montgomery County, Maryland",7227,769,579,355,411,190,907,619,483,285,288,1789,1487,779,797,302,643,501,441,185,142,3119,2314,2234,231,805
1400000US24031704000,"Census Tract 7040, Montgomery County, Maryland",6623,690,573,275,339,117,1041,957,710,419,84,1005,639,524,232,366,1176,1022,679,418,154,2711,2546,2421,212,165
1400000US24031704100,"Census Tract 7041, Montgomery County, Maryland",4279,108,94,67,92,14,259,247,139,178,12,252,223,206,97,29,188,188,185,66,0,3472,3446,3391,469,26
1400000US24031704200,"Census Tract 7042, Montgomery County, Maryland",1906,127,108,53,92,19,221,180,149,83,41,170,156,143,75,14,208,201,201,27,7,1180,1154,1135,121,26
1400000US24031704300,"Census Tract 7043, Montgomery County, Maryland",3596,136,136,123,72,0,216,191,184,63,25,175,175,175,35,0,460,447,437,99,13,2609,2566,2566,167,43
1400000US24031704401,"Census Tract 7044.01, Montgomery County, Maryland",2922,149,29,29,18,120,87,82,82,32,5,173,173,163,26,0,265,265,247,92,0,2248,2183,2035,417,65
1400000US24031704403,"Census Tract 7044.03, Montgomery County, Maryland",1458,74,56,44,48,18,228,217,209,131,11,206,163,135,95,43,171,171,171,11,0,779,757,726,175,22
1400000US24031704404,"Census Tract 7044.04, Montgomery County, Maryland",5086,104,104,88,104,0,249,216,201,141,33,396,396,331,201,0,413,313,264,102,100,3924,3908,3879,584,16
1400000US24031704501,"Census Tract 7045.01, Montgomery County, Maryland",3302,179,165,73,101,14,159,117,101,60,42,284,284,284,68,0,220,150,144,47,70,2460,2434,2376,344,26
1400000US24031704502,"Census Tract 7045.02, Montgomery County, Maryland",2631,76,76,59,37,0,20,20,15,14,0,63,45,8,45,18,114,101,101,50,13,2358,2340,2332,348,18
1400000US24031704503,"Census Tract 7045.03, Montgomery County, Maryland",3797,26,26,26,7,0,152,142,93,107,10,240,240,240,145,0,321,276,256,98,45,3058,2988,2955,244,70
1400000US24031704600,"Census Tract 7046, Montgomery County, Maryland",5184,225,203,203,71,22,317,289,289,141,28,212,212,212,50,0,382,369,353,90,13,4048,3966,3966,393,82
1400000US24031704700,"Census Tract 7047, Montgomery County, Maryland",3858,48,48,34,24,0,253,245,132,164,8,193,158,135,81,35,88,74,68,64,14,3276,3203,3184,337,73
1400000US24031704803,"Census Tract 7048.03, Montgomery County, Maryland",3296,263,248,160,173,15,449,365,322,73,84,1026,824,824,12,202,365,365,365,40,0,1193,1193,1179,86,0
1400000US24031704804,"Census Tract 7048.04, Montgomery County, Maryland",1333,14,14,14,0,0,150,106,106,45,44,260,260,260,61,0,99,99,99,0,0,810,802,776,213,8
1400000US24031704805,"Census Tract 7048.05, Montgomery County, Maryland",1537,231,129,64,116,102,119,119,104,36,0,49,28,28,0,21,110,110,110,12,0,1028,978,943,120,50
1400000US24031704806,"Census Tract 7048.06, Montgomery County, Maryland",2964,138,138,138,45,0,84,84,84,9,0,816,786,786,13,30,410,401,401,29,9,1516,1504,1504,103,12
1400000US24031705000,"Census Tract 7050, Montgomery County, Maryland",3864,255,255,246,107,0,216,212,192,112,4,290,290,266,95,0,331,253,159,105,78,2772,2764,2670,308,8
1400000US24031705100,"Census Tract 7051, Montgomery County, Maryland",5023,140,140,131,99,0,162,152,123,79,10,300,273,197,171,27,167,167,140,52,0,4254,4210,4123,655,44
1400000US24031705200,"Census Tract 7052, Montgomery County, Maryland",3345,10,10,10,0,0,31,31,22,27,0,54,54,44,20,0,181,181,149,105,0,3069,3056,3000,421,13
1400000US24031705300,"Census Tract 7053, Montgomery County, Maryland",1933,13,13,7,9,0,20,20,20,18,0,23,19,19,8,4,68,68,66,18,0,1809,1791,1751,283,18
1400000US24031705400,"Census Tract 7054, Montgomery County, Maryland",2841,53,53,48,31,0,39,39,34,5,0,122,112,96,76,10,81,81,58,49,0,2546,2524,2474,236,22
1400000US24031705501,"Census Tract 7055.01, Montgomery County, Maryland",2407,271,239,149,118,32,244,231,172,215,13,242,229,229,87,13,273,273,273,30,0,1377,1377,1274,673,0
1400000US24031705502,"Census Tract 7055.02, Montgomery County, Maryland",3941,171,107,99,44,64,135,133,131,71,2,246,246,242,63,0,180,180,178,59,0,3209,3177,3026,524,32
1400000US24031705601,"Census Tract 7056.01, Montgomery County, Maryland",2778,45,45,45,0,0,62,53,53,30,9,175,175,175,70,0,70,58,36,33,12,2426,2415,2369,212,11
1400000US24031705602,"Census Tract 7056.02, Montgomery County, Maryland",4295,233,203,187,64,30,476,418,401,222,58,730,690,673,85,40,777,747,685,220,30,2079,2065,1971,434,14
1400000US24031705701,"Census Tract 7057.01, Montgomery County, Maryland",4183,221,201,192,78,20,182,182,133,101,0,130,130,115,70,0,226,226,214,35,0,3424,3424,3376,411,0
1400000US24031705702,"Census Tract 7057.02, Montgomery County, Maryland",4416,101,69,45,35,32,176,176,156,133,0,205,205,164,145,0,245,245,205,102,0,3689,3656,3528,704,33
1400000US24031705800,"Census Tract 7058, Montgomery County, Maryland",6373,190,173,157,85,17,419,354,293,85,65,376,376,373,78,0,344,344,343,95,0,5044,4745,4633,603,299
1400000US24031705901,"Census Tract 7059.01, Montgomery County, Maryland",3811,25,25,25,0,0,54,54,54,38,0,103,103,103,68,0,190,177,159,83,13,3439,3411,3334,648,28
1400000US24031705902,"Census Tract 7059.02, Montgomery County, Maryland",4258,40,40,40,40,0,203,177,142,117,26,248,248,235,24,0,224,185,137,83,39,3543,3444,3387,498,99
1400000US24031705903,"Census Tract 7059.03, Montgomery County, Maryland",4547,117,117,117,11,0,125,97,84,97,28,144,144,134,53,0,306,306,306,45,0,3855,3818,3712,523,37
1400000US24031706005,"Census Tract 7060.05, Montgomery County, Maryland",4677,167,167,156,50,0,246,73,56,73,173,262,238,219,64,24,163,154,104,103,9,3839,3699,3616,631,140
1400000US24031706007,"Census Tract 7060.07, Montgomery County, Maryland",7062,16,16,16,0,0,251,237,141,138,14,183,183,183,12,0,652,634,619,89,18,5960,5500,5322,886,460
1400000US24031706008,"Census Tract 7060.08, Montgomery County, Maryland",5183,61,61,61,29,0,121,121,121,46,0,41,41,30,21,0,257,229,199,46,28,4703,4673,4577,686,30
1400000US24031706009,"Census Tract 7060.09, Montgomery County, Maryland",5683,155,155,123,52,0,87,87,75,34,0,287,253,172,113,34,202,192,170,93,10,4952,4789,4747,674,163
1400000US24031706010,"Census Tract 7060.10, Montgomery County, Maryland",2663,181,154,154,51,27,211,192,166,65,19,157,148,148,56,9,132,132,100,53,0,1982,1972,1934,313,10
1400000US24031706011,"Census Tract 7060.11, Montgomery County, Maryland",5141,155,155,155,19,0,186,160,146,58,26,171,171,171,85,0,134,134,123,37,0,4495,4425,4321,654,70
1400000US24031706012,"Census Tract 7060.12, Montgomery County, Maryland",3120,454,398,224,309,56,414,373,287,292,41,525,507,507,154,18,588,588,588,125,0,1139,1101,1101,89,38
1400000US24031706013,"Census Tract 7060.13, Montgomery County, Maryland",2853,29,29,17,12,0,56,31,31,19,25,54,54,40,54,0,91,91,91,38,0,2623,2546,2402,368,77
1400000US24033800102,"Census Tract 8001.02, Prince George's County, Maryland",3132,379,178,151,137,201,492,350,206,205,142,1069,945,715,295,124,378,356,332,71,22,814,765,705,189,49
1400000US24033800103,"Census Tract 8001.03, Prince George's County, Maryland",2198,260,120,53,86,140,377,330,256,94,47,524,369,343,26,155,260,233,230,17,27,777,607,399,211,170
1400000US24033800105,"Census Tract 8001.05, Prince George's County, Maryland",3772,145,124,30,94,21,448,238,181,102,210,673,467,379,177,206,428,370,370,32,58,2078,1958,1831,219,120
1400000US24033800106,"Census Tract 8001.06, Prince George's County, Maryland",2458,167,140,76,87,27,105,105,98,27,0,419,369,369,21,50,554,482,380,116,72,1213,1078,996,150,135
1400000US24033800108,"Census Tract 8001.08, Prince George's County, Maryland",3020,260,181,112,78,79,279,218,203,96,61,900,813,578,295,87,178,163,163,0,15,1403,1132,955,317,271
1400000US24033800109,"Census Tract 8001.09, Prince George's County, Maryland",4009,449,347,158,205,102,833,518,200,371,315,1124,1007,740,331,117,878,781,777,337,97,725,643,503,218,82
1400000US24033800203,"Census Tract 8002.03, Prince George's County, Maryland",4513,63,63,50,38,0,396,280,261,166,116,340,340,322,131,0,259,244,244,153,15,3455,2983,2927,373,472
1400000US24033800206,"Census Tract 8002.06, Prince George's County, Maryland",4072,287,185,84,120,102,411,356,262,119,55,606,508,494,45,98,986,840,722,193,146,1782,1644,1550,211,138
1400000US24033800208,"Census Tract 8002.08, Prince George's County, Maryland",7317,88,46,24,22,42,1020,876,745,283,144,1526,1373,1146,329,153,1048,894,727,303,154,3635,3499,3387,463,136
1400000US24033800209,"Census Tract 8002.09, Prince George's County, Maryland",3398,333,190,99,104,143,961,764,572,305,197,929,817,628,270,112,454,357,299,98,97,721,568,531,82,153
1400000US24033800210,"Census Tract 8002.10, Prince George's County, Maryland",3170,393,312,61,262,81,504,397,187,218,107,998,789,564,316,209,748,458,369,112,290,527,507,507,31,20
1400000US24033800211,"Census Tract 8002.11, Prince George's County, Maryland",2652,341,262,195,148,79,856,662,578,140,194,493,344,336,33,149,462,422,362,60,40,500,500,500,56,0
1400000US24033800212,"Census Tract 8002.12, Prince George's County, Maryland",3843,239,164,121,96,75,169,153,143,100,16,721,562,523,106,159,608,586,546,224,22,2106,1916,1770,336,190
1400000US24033800213,"Census Tract 8002.13, Prince George's County, Maryland",3884,494,401,178,239,93,695,563,361,212,132,395,366,356,55,29,989,835,835,63,154,1311,1248,1195,137,63
1400000US24033800214,"Census Tract 8002.14, Prince George's County, Maryland",2312,127,83,73,52,44,588,437,317,120,151,466,409,360,49,57,247,226,226,23,21,884,767,643,251,117
1400000US24033800215,"Census Tract 8002.15, Prince George's County, Maryland",2552,52,49,49,40,3,238,238,238,0,0,700,535,386,149,165,789,607,544,85,182,773,728,703,183,45
1400000US24033800401,"Census Tract 8004.01, Prince George's County, Maryland",2965,167,167,22,163,0,266,252,241,78,14,227,176,134,95,51,366,353,353,62,13,1939,1683,1521,408,256
1400000US24033800402,"Census Tract 8004.02, Prince George's County, Maryland",4771,111,104,80,104,7,462,352,307,122,110,631,540,510,144,91,767,767,728,141,0,2800,2727,2598,498,73
1400000US24033800403,"Census Tract 8004.03, Prince George's County, Maryland",4033,28,28,6,28,0,263,212,147,179,51,218,192,162,137,26,549,549,549,120,0,2975,2818,2716,357,157
1400000US24033800408,"Census Tract 8004.08, Prince George's County, Maryland",6751,190,142,56,99,48,522,448,418,107,74,875,748,740,121,127,839,763,710,239,76,4325,4148,3999,330,177
1400000US24033800409,"Census Tract 8004.09, Prince George's County, Maryland",6200,182,86,71,62,96,267,209,111,144,58,949,723,587,201,226,1137,984,789,358,153,3665,3511,3453,443,154
1400000US24033800410,"Census Tract 8004.10, Prince George's County, Maryland",5446,103,45,45,7,58,554,413,277,190,141,231,197,189,15,34,569,420,391,54,149,3989,3848,3750,382,141
1400000US24033800411,"Census Tract 8004.11, Prince George's County, Maryland",4061,381,290,119,197,91,291,258,139,144,33,767,594,528,120,173,727,727,727,16,0,1895,1796,1796,194,99
1400000US24033800412,"Census Tract 8004.12, Prince George's County, Maryland",3200,259,106,46,83,153,760,437,395,94,323,360,341,278,114,19,734,678,678,126,56,1087,944,926,98,143
1400000US24033800413,"Census Tract 8004.13, Prince George's County, Maryland",3561,198,176,51,142,22,643,469,294,201,174,548,482,466,52,66,1068,1008,970,89,60,1104,1073,1006,102,31
1400000US24033800504,"Census Tract 8005.04, Prince George's County, Maryland",4774,156,144,86,144,12,213,196,148,126,17,533,396,353,141,137,466,466,453,102,0,3406,3284,3108,520,122
